2EBACB57-730B-E811-80C3-3863BB430E3F,11235,40.577224,-73.967061,2.7,"SFR,PERMANENT LIVING",A2,RR101,1,,7993,11414,19407,194000,277000,471000,2017
3A66D757-730B-E811-80C3-3863BB430E3F,11235,40.576927,-73.966949,2.7,"SFR,PERMANENT LIVING",A2,RR101,1,,8663,10413,19076,198000,238000,436000,2017
4A15AA57-730B-E811-80C3-3863BB430E3F,11235,40.5878,-73.966849,3,"SINGLE FAM RES,ATTAC",A5,RR101,1,,6507,22953,29460,165000,582000,747000,2017
5BC1BA57-730B-E811-80C3-3863BB430E3F,11235,40.576957,-73.96681,2.7,"SFR,PERMANENT LIVING",A2,RR101,1,,5464,11954,17418,133000,291000,424000,2017
32E5CD57-730B-E811-80C3-3863BB430E3F,11235,40.579096,-73.966767,2.4,"SFR,PERMANENT LIVING",A2,RR101,1,,12759,17514,30273,271000,372000,643000,2017
74DFD957-730B-E811-80C3-3863BB430E3F,11235,40.58098,-73.966759,2.4,"SFR,PERMANENT LIVING",A2,RR101,1,,4580,8779,13359,108000,207000,315000,2017
013DBD57-730B-E811-80C3-3863BB430E3F,11235,40.581037,-73.966746,2.5,"SFR,PERMANENT LIVING",A2,RR101,1,,5187,8027,13214,126000,195000,321000,2017
F63A9E57-730B-E811-80C3-3863BB430E3F,11235,40.58136,-73.966593,2.6,"SFR,PERMANENT LIVING",A2,RR101,1,,2575,5961,8536,70000,162000,232000,2017
54C8D957-730B-E811-80C3-3863BB430E3F,11235,40.579375,-73.966523,2.3,"SFR,PERMANENT LIVING",A2,RR101,1,,7144,12878,20022,157000,283000,440000,2017
86D0BF57-730B-E811-80C3-3863BB430E3F,11235,40.590694,-73.966163,3.2,LARGE SUBURBAN RESID,A3,RR101,1,,10739,27119,37858,257000,649000,906000,2017
3275C457-730B-E811-80C3-3863BB430E3F,11235,40.579868,-73.966128,2.2,"SFR,PERMANENT LIVING",A2,RR101,1,,10647,9705,20352,226000,206000,432000,2017
3A23D557-730B-E811-80C3-3863BB430E3F,11235,40.579247,-73.966018,2.5,"SFR,PERMANENT LIVING",A2,RR101,1,,5984,8081,14065,194000,262000,456000,2017
BEBCBF57-730B-E811-80C3-3863BB430E3F,11235,40.579621,-73.965933,2.4,"SFR,PERMANENT LIVING",A2,RR101,1,,6003,10585,16588,169000,298000,467000,2017
2C8EBF57-730B-E811-80C3-3863BB430E3F,11235,40.579485,-73.965356,2.5,"SFR,PERMANENT LIVING",A2,RR101,1,,6225,9617,15842,145000,224000,369000,2017
7ED9CD57-730B-E811-80C3-3863BB430E3F,11235,40.579659,-73.965272,2.5,"SFR,PERMANENT LIVING",A2,RR101,1,,5783,7801,13584,149000,201000,350000,2017
F459A557-730B-E811-80C3-3863BB430E3F,11235,40.57923,-73.965263,2.7,"SFR,PERMANENT LIVING",A2,RR101,1,,7151,12973,20124,156000,283000,439000,2017
28CACB57-730B-E811-80C3-3863BB430E3F,11235,40.579151,-73.965234,2.7,"SFR,PERMANENT LIVING",A2,RR101,1,,6035,10183,16218,128000,216000,344000,2017
47B0B357-730B-E811-80C3-3863BB430E3F,11235,40.57952,-73.965191,2.5,"SFR,PERMANENT LIVING",A2,RR101,1,,8005,8340,16345,167000,174000,341000,2017
90A3BF57-730B-E811-80C3-3863BB430E3F,11235,40.581585,-73.965118,2.7,"SFR,PERMANENT LIVING",A2,RR101,1,,6448,10748,17196,168000,280000,448000,2017
A48FC457-730B-E811-80C3-3863BB430E3F,11235,40.581792,-73.965022,2.7,"SFR,PERMANENT LIVING",A2,RR101,1,,6270,10926,17196,136000,237000,373000,2017
E8329E57-730B-E811-80C3-3863BB430E3F,11235,40.581857,-73.964992,2.7,"SFR,PERMANENT LIVING",A2,RR101,1,,5815,10903,16718,144000,270000,414000,2017
0E83CB57-730B-E811-80C3-3863BB430E3F,11235,40.581935,-73.964956,2.7,"SFR,PERMANENT LIVING",A2,RR101,1,,6459,11872,18331,148000,272000,420000,2017
185AC457-730B-E811-80C3-3863BB430E3F,11235,40.579843,-73.964943,2.5,"SFR,PERMANENT LIVING",A2,RR101,1,,6960,13164,20124,212000,401000,613000,2017
AC8BCB57-730B-E811-80C3-3863BB430E3F,11235,40.579281,-73.964693,2.7,"SFR,PERMANENT LIVING",A2,RR101,1,,6216,12295,18511,180000,356000,536000,2017
E2D3BF57-730B-E811-80C3-3863BB430E3F,11235,40.580205,-73.964645,2.5,"SFR,PERMANENT LIVING",A2,RR101,1,,5890,8941,14831,139000,211000,350000,2017
FF3DBD57-730B-E811-80C3-3863BB430E3F,11235,40.580392,-73.964563,2.5,"SFR,PERMANENT LIVING",A2,RR101,1,,7709,9989,17698,169000,219000,388000,2017
394FBD57-730B-E811-80C3-3863BB430E3F,11235,40.580264,-73.964369,2.5,"SFR,PERMANENT LIVING",A2,RR101,1,,6509,8635,15144,150000,199000,349000,2017
B423DC57-730B-E811-80C3-3863BB430E3F,11235,40.580452,-73.964283,2.5,"SFR,PERMANENT LIVING",A2,RR101,1,,7799,9934,17733,190000,242000,432000,2017
611BB657-730B-E811-80C3-3863BB430E3F,11235,40.579402,-73.96418,2.8,"SFR,PERMANENT LIVING",A2,RR101,1,,6874,10181,17055,158000,234000,392000,2017
D28BA057-730B-E811-80C3-3863BB430E3F,11235,40.579951,-73.96394,2.7,"SFR,PERMANENT LIVING",A2,RR101,1,,8091,9658,17749,191000,228000,419000,2017
EE99BF57-730B-E811-80C3-3863BB430E3F,11235,40.579476,-73.963778,2.7,"SFR,PERMANENT LIVING",A2,RR101,1,,6907,10705,17612,151000,234000,385000,2017
582CDC57-730B-E811-80C3-3863BB430E3F,11235,40.579367,-73.963738,2.7,"SFR,PERMANENT LIVING",A2,RR101,1,,5149,5090,10239,175000,173000,348000,2017
609ECB57-730B-E811-80C3-3863BB430E3F,11235,40.579867,-73.963545,2.7,"SFR,PERMANENT LIVING",A2,RR101,1,,8444,12625,21069,200000,299000,499000,2017
B96BA557-730B-E811-80C3-3863BB430E3F,11235,40.580051,-73.963472,2.7,"SFR,PERMANENT LIVING",A2,RR101,1,,7907,12513,20420,182000,288000,470000,2017
6802C257-730B-E811-80C3-3863BB430E3F,11235,40.588385,-73.963376,3.2,"SINGLE FAM RES,ATTAC",A5,RR101,1,,6867,22329,29196,167000,543000,710000,2017
980AC257-730B-E811-80C3-3863BB430E3F,11235,40.580728,-73.962444,2.7,"SFR,PERMANENT LIVING",A2,RR101,1,,9662,11171,20833,192000,222000,414000,2017
8C36D057-730B-E811-80C3-3863BB430E3F,11235,40.585398,-73.962444,3.1,"SINGLE FAM RES,ATTAC",A5,RR101,1,,8101,23195,31296,197000,564000,761000,2017
36A2CB57-730B-E811-80C3-3863BB430E3F,11235,40.580247,-73.961745,2.7,"SFR,PERMANENT LIVING",A2,RR101,1,,7839,8744,16583,156000,174000,330000,2017
7DCFBA57-730B-E811-80C3-3863BB430E3F,11235,40.580437,-73.961643,2.7,"SFR,PERMANENT LIVING",A2,RR101,1,,12486,10562,23048,240000,203000,443000,2017
0343B157-730B-E811-80C3-3863BB430E3F,11235,40.58028,-73.961586,2.7,"SFR,PERMANENT LIVING",A2,RR101,1,,9163,7298,16461,172000,137000,309000,2017
1507C255-730B-E811-80C3-3863BB430E3F,11235,40.580569,-73.96157,2.7,"SFR,PERMANENT LIVING",A2,RR101,1,,6283,7956,14239,154000,195000,349000,2017
1828C957-730B-E811-80C3-3863BB430E3F,11235,40.578576,-73.961146,2.7,"SFR,PERMANENT LIVING",A2,RR101,1,,9805,10399,20204,198000,210000,408000,2017
206EC457-730B-E811-80C3-3863BB430E3F,11235,40.578471,-73.961113,2.7,"SFR,PERMANENT LIVING",A2,RR101,1,,10771,6892,17663,286000,183000,469000,2017
4D54BD57-730B-E811-80C3-3863BB430E3F,11235,40.578754,-73.961012,2.7,"SFR,PERMANENT LIVING",A2,RR101,1,,10860,,10860,181000,,181000,2017
0407C257-730B-E811-80C3-3863BB430E3F,11235,40.578513,-73.960963,2.7,"SFR,PERMANENT LIVING",A2,RR101,1,,11539,11540,23079,204000,204000,408000,2017
4008D557-730B-E811-80C3-3863BB430E3F,11235,40.580935,-73.960952,2.7,"SFR,PERMANENT LIVING",A2,RR101,1,,7853,6386,14239,198000,161000,359000,2017
CA40AA57-730B-E811-80C3-3863BB430E3F,11235,40.579289,-73.960778,2.7,"SFR,PERMANENT LIVING",A2,RR101,1,,8976,12838,21814,172000,246000,418000,2017
E2B3CB57-730B-E811-80C3-3863BB430E3F,11235,40.580639,-73.960692,2.8,"SFR,PERMANENT LIVING",A2,RR101,1,,9372,8062,17434,186000,160000,346000,2017
A7B0B357-730B-E811-80C3-3863BB430E3F,11235,40.578645,-73.96068,2.7,"SFR,PERMANENT LIVING",A2,RR101,1,,9262,11853,21115,168000,215000,383000,2017
0A28C257-730B-E811-80C3-3863BB430E3F,11235,40.590732,-73.960316,3.5,"SINGLE FAM RES,ATTAC",A5,RR101,1,,6150,12837,18987,149000,311000,460000,2017
8A429E57-730B-E811-80C3-3863BB430E3F,11235,40.591838,-73.960201,3.2,"SFR,PERMANENT LIVING",A2,RR101,1,,7435,14419,21854,214000,415000,629000,2017
FE97D257-730B-E811-80C3-3863BB430E3F,11235,40.59185,-73.960089,3.2,"SFR,PERMANENT LIVING",A2,RR101,1,,6850,13570,20420,211000,418000,629000,2017
EDB3B357-730B-E811-80C3-3863BB430E3F,11235,40.58656,-73.959994,3.4,"SFR,PERMANENT LIVING",A2,RR101,1,,7942,13554,21496,167000,285000,452000,2017
28C4A057-730B-E811-80C3-3863BB430E3F,11235,40.586259,-73.95997,3.9,"SFR,PERMANENT LIVING",A2,RR101,1,,6483,11073,17556,202000,345000,547000,2017
0E98B857-730B-E811-80C3-3863BB430E3F,11235,40.580289,-73.959863,2.7,"SFR,PERMANENT LIVING",A2,RR101,1,,9458,10666,20124,188000,212000,400000,2017
2197B357-730B-E811-80C3-3863BB430E3F,11235,40.59085,-73.959798,3.5,"SFR,PERMANENT LIVING",A2,RR101,1,,10026,17951,27977,186000,333000,519000,2017
CED7CB57-730B-E811-80C3-3863BB430E3F,11235,40.585336,-73.959792,3.3,"SFR,PERMANENT LIVING",A2,RR101,1,,5112,11011,16123,117000,252000,369000,2017
54359E57-730B-E811-80C3-3863BB430E3F,11235,40.580301,-73.9596,2.7,"SFR,PERMANENT LIVING",A2,RR101,1,,10836,12220,23056,188000,212000,400000,2017
8491B857-730B-E811-80C3-3863BB430E3F,11235,40.58668,-73.959459,3.4,"SFR,PERMANENT LIVING",A2,RR101,1,,3595,11093,14688,82000,253000,335000,2017
4EFFD457-730B-E811-80C3-3863BB430E3F,11235,40.590447,-73.959455,3.6,"SINGLE FAM RES, DETA",A1,RR101,1,,8768,28635,37403,192000,627000,819000,2017
01F3AE57-730B-E811-80C3-3863BB430E3F,11235,40.5867,-73.95937,3.3,"SFR,PERMANENT LIVING",A2,RR101,1,,4529,9442,13971,118000,246000,364000,2017
10CCD957-730B-E811-80C3-3863BB430E3F,11235,40.586715,-73.95928,3.3,"SFR,PERMANENT LIVING",A2,RR101,1,,4940,9031,13971,122000,223000,345000,2017
7FD9B357-730B-E811-80C3-3863BB430E3F,11235,40.586078,-73.959219,3.1,"SINGLE FAM RES,ATTAC",A5,RR101,1,,4418,8837,13255,147000,294000,441000,2017
1649A557-730B-E811-80C3-3863BB430E3F,11235,40.580318,-73.959211,2.7,"SFR,PERMANENT LIVING",A2,RR101,1,,12300,9120,21420,205000,152000,357000,2017
33D1BA57-730B-E811-80C3-3863BB430E3F,11235,40.583325,-73.959177,3.4,"SFR,PERMANENT LIVING",A2,RR101,1,,9497,6626,16123,215000,150000,365000,2017
AA2EC257-730B-E811-80C3-3863BB430E3F,11235,40.585654,-73.959145,3,"SFR,PERMANENT LIVING",A2,RR101,1,,5567,9478,15045,158000,269000,427000,2017
F647AA57-730B-E811-80C3-3863BB430E3F,11235,40.583337,-73.959059,3.4,"SFR,PERMANENT LIVING",A2,RR101,1,,9897,10843,20740,178000,195000,373000,2017
E7D19B57-730B-E811-80C3-3863BB430E3F,11235,40.579956,-73.958987,2.7,"SFR,PERMANENT LIVING",A2,RR101,1,,9118,10586,19704,236000,274000,510000,2017
A963BD57-730B-E811-80C3-3863BB430E3F,11235,40.581578,-73.958934,2.9,"SFR,PERMANENT LIVING",A2,RR101,1,,9819,9919,19738,198000,200000,398000,2017
9C80AC57-730B-E811-80C3-3863BB430E3F,11235,40.581812,-73.958805,2.8,"SFR,PERMANENT LIVING",A2,RR101,1,,4796,11792,16588,146000,359000,505000,2017
F86DAC57-730B-E811-80C3-3863BB430E3F,11235,40.581584,-73.958789,2.8,"SFR,PERMANENT LIVING",A2,RR101,1,,9499,10406,19905,199000,218000,417000,2017
6C24C257-730B-E811-80C3-3863BB430E3F,11235,40.583367,-73.958785,3.3,"SFR,PERMANENT LIVING",A2,RR101,1,,9028,5302,14330,172000,101000,273000,2017
D886CB57-730B-E811-80C3-3863BB430E3F,11235,40.580246,-73.958781,2.7,"SFR,PERMANENT LIVING",A2,RR101,1,,10027,10753,20780,235000,252000,487000,2017
F28DA057-730B-E811-80C3-3863BB430E3F,11235,40.580246,-73.958781,2.7,"SFR,PERMANENT LIVING",A2,RR101,1,,10027,10753,20780,235000,252000,487000,2017
6AEDBF57-730B-E811-80C3-3863BB430E3F,11235,40.586132,-73.958725,3.1,"SFR,PERMANENT LIVING",A2,RR101,1,,7230,11040,18270,167000,255000,422000,2017
41DBBA57-730B-E811-80C3-3863BB430E3F,11235,40.580342,-73.958713,2.7,"SFR,PERMANENT LIVING",A2,RR101,1,,8027,13469,21496,236000,396000,632000,2017
3375A557-730B-E811-80C3-3863BB430E3F,11235,40.583383,-73.958639,3.3,"SFR,PERMANENT LIVING",A2,RR101,1,,7116,7681,14797,151000,163000,314000,2017
70E7BF57-730B-E811-80C3-3863BB430E3F,11235,40.58625,-73.9586,3.3,"SFR,PERMANENT LIVING",A2,RR101,1,,5037,8575,13612,131000,223000,354000,2017
6C13C257-730B-E811-80C3-3863BB430E3F,11235,40.58171,-73.958582,2.9,"SFR,PERMANENT LIVING",A2,RR101,1,,5428,11823,17251,146000,318000,464000,2017
2ADACD57-730B-E811-80C3-3863BB430E3F,11235,40.586113,-73.95857,3.1,"SFR,PERMANENT LIVING",A2,RR101,1,,5414,7482,12896,144000,199000,343000,2017
2BEAAE57-730B-E811-80C3-3863BB430E3F,11235,40.588833,-73.958549,3.1,"SFR,PERMANENT LIVING",A2,RR101,1,,13670,25498,39168,304000,567000,871000,2017
AE2B9E57-730B-E811-80C3-3863BB430E3F,11235,40.580632,-73.958507,2.7,"SFR,PERMANENT LIVING",A2,RR101,1,,10175,12219,22394,239000,287000,526000,2017
4671D757-730B-E811-80C3-3863BB430E3F,11235,40.580825,-73.958369,2.7,"SFR,PERMANENT LIVING",A2,RR101,1,,8211,10567,18778,223000,287000,510000,2017
7F3DB157-730B-E811-80C3-3863BB430E3F,11235,40.583421,-73.958287,3.2,"SFR,PERMANENT LIVING",A2,RR101,1,,8888,7901,16789,189000,168000,357000,2017
7F6C9957-730B-E811-80C3-3863BB430E3F,11235,40.586959,-73.958188,3,"SFR,PERMANENT LIVING",A2,RR101,1,,8638,9276,17914,203000,218000,421000,2017
B24FC457-730B-E811-80C3-3863BB430E3F,11235,40.581114,-73.958163,2.8,"SFR,PERMANENT LIVING",A2,RR101,1,,10529,9175,19704,241000,210000,451000,2017
42C8CB57-730B-E811-80C3-3863BB430E3F,11235,40.581404,-73.957957,2.9,"SFR,PERMANENT LIVING",A2,RR101,1,,7377,11970,19347,241000,391000,632000,2017
1322BD57-730B-E811-80C3-3863BB430E3F,11235,40.581501,-73.957888,2.9,"SFR,PERMANENT LIVING",A2,RR101,1,,9574,9773,19347,241000,246000,487000,2017
6A60B857-730B-E811-80C3-3863BB430E3F,11235,40.581599,-73.957818,3,"SFR,PERMANENT LIVING",A2,RR101,1,,6756,12231,18987,211000,382000,593000,2017
B082C457-730B-E811-80C3-3863BB430E3F,11235,40.581695,-73.957749,3,"SFR,PERMANENT LIVING",A2,RR101,1,,6933,12054,18987,241000,419000,660000,2017
E22BD557-730B-E811-80C3-3863BB430E3F,11235,40.581789,-73.957683,3.1,"SFR,PERMANENT LIVING",A2,RR101,1,,6857,11921,18778,241000,419000,660000,2017
3F029C57-730B-E811-80C3-3863BB430E3F,11235,40.581882,-73.957616,3.1,"SFR,PERMANENT LIVING",A2,RR101,1,,6999,11779,18778,246000,414000,660000,2017
8977A557-730B-E811-80C3-3863BB430E3F,11235,40.591297,-73.957551,3.1,"SFR,PERMANENT LIVING",A2,RR101,1,,4813,10232,15045,143000,304000,447000,2017
E198B357-730B-E811-80C3-3863BB430E3F,11235,40.591244,-73.95752,3.2,"SFR,PERMANENT LIVING",A2,RR101,1,,4581,8136,12717,125000,222000,347000,2017
F594B357-730B-E811-80C3-3863BB430E3F,11235,40.58635,-73.956659,3.1,"SINGLE FAM RES, DETA",A1,RR101,1,,4165,8017,12182,146000,281000,427000,2017
5312C255-730B-E811-80C3-3863BB430E3F,11235,40.58926,-73.955313,3.6,"SINGLE FAM RES,ATTAC",A5,RR101,1,,9560,20014,29574,203000,425000,628000,2017
B635AA57-730B-E811-80C3-3863BB430E3F,11235,40.580801,-73.954288,2.6,"SFR,PERMANENT LIVING",A2,RR101,1,,7533,11543,19076,263000,403000,666000,2017
DAEACD57-730B-E811-80C3-3863BB430E3F,11235,40.592013,-73.953931,7,"SINGLE FAM RES,ATTAC",A5,RR101,1,,7727,23057,30784,186000,555000,741000,2017
3CF6D457-730B-E811-80C3-3863BB430E3F,11235,40.591714,-73.953874,7,"SINGLE FAM RES,ATTAC",A5,RR101,1,,9587,23921,33508,212000,529000,741000,2017
4247AA57-730B-E811-80C3-3863BB430E3F,11235,40.576472,-73.953523,1.9,"SFR,PERMANENT LIVING",A2,RR101,1,,12348,39073,51421,262000,829000,1091000,2017
05C5B357-730B-E811-80C3-3863BB430E3F,11235,40.576383,-73.953506,1.8,"SFR,PERMANENT LIVING",A2,RR101,1,,14832,38748,53580,351000,917000,1268000,2017
6869B857-730B-E811-80C3-3863BB430E3F,11235,40.592583,-73.953456,6.7,"SINGLE FAM RES,ATTAC",A5,RR101,1,,8509,24093,32602,178000,504000,682000,2017
86EABF57-730B-E811-80C3-3863BB430E3F,11235,40.592106,-73.953248,6.6,"SINGLE FAM RES,ATTAC",A5,RR101,1,,7838,20693,28531,200000,528000,728000,2017
E2EEA257-730B-E811-80C3-3863BB430E3F,11235,40.592609,-73.953222,6.5,"SINGLE FAM RES,ATTAC",A5,RR101,1,,8463,23783,32246,179000,503000,682000,2017
F289A557-730B-E811-80C3-3863BB430E3F,11235,40.592116,-73.953159,6.6,"SINGLE FAM RES,ATTAC",A5,RR101,1,,7670,23444,31114,213000,651000,864000,2017
AA6ECB57-730B-E811-80C3-3863BB430E3F,11235,40.592617,-73.953145,6.5,"SINGLE FAM RES,ATTAC",A5,RR101,1,,8652,23950,32602,181000,501000,682000,2017
5A15C257-730B-E811-80C3-3863BB430E3F,11235,40.577373,-73.953071,2.5,"SFR,PERMANENT LIVING",A2,RR101,1,,5134,9911,15045,173000,334000,507000,2017
E45ED757-730B-E811-80C3-3863BB430E3F,11235,40.592634,-73.952989,6.4,"SINGLE FAM RES,ATTAC",A5,RR101,1,,8416,23830,32246,178000,504000,682000,2017
D6A1B857-730B-E811-80C3-3863BB430E3F,11235,40.577388,-73.95296,2.4,"SFR,PERMANENT LIVING",A2,RR101,1,,3431,10005,13436,142000,414000,556000,2017
F175A557-730B-E811-80C3-3863BB430E3F,11235,40.592145,-73.952887,6.4,"SINGLE FAM RES,ATTAC",A5,RR101,1,,8978,19172,28150,244000,521000,765000,2017
2A85C457-730B-E811-80C3-3863BB430E3F,11235,40.591623,-73.952883,6.4,"SINGLE FAM RES,ATTAC",A5,RR101,1,,10562,24668,35230,292000,682000,974000,2017
6426C957-730B-E811-80C3-3863BB430E3F,11235,40.579708,-73.952589,1.8,"SFR,PERMANENT LIVING",A2,RR101,1,,13158,22672,35830,462000,796000,1258000,2017
1B4BB157-730B-E811-80C3-3863BB430E3F,11235,40.581532,-73.952478,0.3,"SINGLE FAM RES, DETA",A1,RR101,1,,22866,55104,77970,549000,1323000,1872000,2017
785AC457-730B-E811-80C3-3863BB430E3F,11235,40.591976,-73.952339,6,"SINGLE FAM RES,ATTAC",A5,RR101,1,,6427,18749,25176,193000,563000,756000,2017
7E53D057-730B-E811-80C3-3863BB430E3F,11235,40.591916,-73.952327,6,"SINGLE FAM RES,ATTAC",A5,RR101,1,,6506,17230,23736,199000,527000,726000,2017
6E77C457-730B-E811-80C3-3863BB430E3F,11235,40.591726,-73.952255,5.8,"SINGLE FAM RES,ATTAC",A5,RR101,1,,8822,21368,30190,237000,574000,811000,2017
3D66A557-730B-E811-80C3-3863BB430E3F,11235,40.592073,-73.951989,5.7,"SINGLE FAM RES,ATTAC",A5,RR101,1,,6962,23165,30127,174000,579000,753000,2017
E2E8CD57-730B-E811-80C3-3863BB430E3F,11235,40.581228,-73.951944,0.5,"SFR,PERMANENT LIVING",A2,RR101,1,,12596,28609,41205,295000,670000,965000,2017
DC97CB57-730B-E811-80C3-3863BB430E3F,11235,40.59171,-73.951921,5.5,"SINGLE FAM RES,ATTAC",A5,RR101,1,,8416,22368,30784,228000,606000,834000,2017
8428D557-730B-E811-80C3-3863BB430E3F,11235,40.591615,-73.951903,5.4,"SINGLE FAM RES,ATTAC",A5,RR101,1,,9425,27069,36494,250000,718000,968000,2017
D9FDAE57-730B-E811-80C3-3863BB430E3F,11235,40.577216,-73.951728,1.4,"SFR,PERMANENT LIVING",A2,RR101,1,,27750,76759,104509,731000,2022000,2753000,2017
85D8BA57-730B-E811-80C3-3863BB430E3F,11235,40.578775,-73.951487,1.6,"SFR,PERMANENT LIVING",A2,RR101,1,,26195,56914,83109,446000,969000,1415000,2017
0845D057-730B-E811-80C3-3863BB430E3F,11235,40.591429,-73.951258,4.6,"SINGLE FAM RES,ATTAC",A5,RR101,1,,7688,22026,29714,185000,530000,715000,2017
E9EEAE57-730B-E811-80C3-3863BB430E3F,11235,40.576808,-73.951006,1.3,"SFR,PERMANENT LIVING",A2,RR101,1,,19733,42662,62395,463000,1001000,1464000,2017
8A42D057-730B-E811-80C3-3863BB430E3F,11235,40.576848,-73.950645,1.3,"SFR,PERMANENT LIVING",A2,RR101,1,,20845,46253,67098,425000,943000,1368000,2017
31C6B357-730B-E811-80C3-3863BB430E3F,11235,40.575809,-73.950532,0.9,"SFR,PERMANENT LIVING",A2,RR101,1,,26793,33792,60585,601000,758000,1359000,2017
6479D757-730B-E811-80C3-3863BB430E3F,11235,40.580614,-73.949556,0.5,"SFR,PERMANENT LIVING",A2,RR101,1,,13664,38590,52254,341000,963000,1304000,2017
9C56A557-730B-E811-80C3-3863BB430E3F,11235,40.576864,-73.949234,1.2,"SFR,PERMANENT LIVING",A2,RR101,1,,22334,48760,71094,513000,1120000,1633000,2017
F296CB57-730B-E811-80C3-3863BB430E3F,11235,40.575447,-73.948966,0.6,"SFR,PERMANENT LIVING",A2,RR101,1,,14492,28703,43195,462000,915000,1377000,2017
E683C457-730B-E811-80C3-3863BB430E3F,11235,40.579266,-73.948745,0.7,"SINGLE FAM RES, DETA",A1,RR101,1,,34028,65378,99406,699000,1343000,2042000,2017
0084A057-730B-E811-80C3-3863BB430E3F,11235,40.581253,-73.947697,0.2,"SINGLE FAM RES, DETA",A1,RR101,1,,38987,80300,119287,838000,1726000,2564000,2017
2735BD57-730B-E811-80C3-3863BB430E3F,11235,40.579765,-73.94685,0.5,"SINGLE FAM RES, DETA",A1,RR101,1,,24406,62517,86923,593000,1519000,2112000,2017
DF31BD57-730B-E811-80C3-3863BB430E3F,11235,40.579635,-73.94683,0.6,"SINGLE FAM RES, DETA",A1,RR101,1,,26860,44968,71828,715000,1197000,1912000,2017
6E5CB857-730B-E811-80C3-3863BB430E3F,11235,40.580871,-73.946688,0.2,"SINGLE FAM RES,ATTAC",A5,RR101,1,,20229,42364,62593,446000,934000,1380000,2017
8E3EDC57-730B-E811-80C3-3863BB430E3F,11235,40.590155,-73.945538,3.2,"SINGLE FAM RES,ATTAC",A5,RR101,1,,6409,21791,28200,165000,561000,726000,2017
CED1CD57-730B-E811-80C3-3863BB430E3F,11235,40.58982,-73.945475,3.1,"SINGLE FAM RES,ATTAC",A5,RR101,1,,7773,23578,31351,180000,546000,726000,2017
7FFFAE57-730B-E811-80C3-3863BB430E3F,11235,40.58976,-73.945464,3.1,"SINGLE FAM RES,ATTAC",A5,RR101,1,,7773,23578,31351,180000,546000,726000,2017
D9FA9B57-730B-E811-80C3-3863BB430E3F,11235,40.590595,-73.944984,3.2,"SINGLE FAM RES,ATTAC",A5,RR101,1,,7548,23126,30674,173000,530000,703000,2017
C433DC57-730B-E811-80C3-3863BB430E3F,11235,40.590525,-73.94497,3.2,"SINGLE FAM RES,ATTAC",A5,RR101,1,,10022,21277,31299,203000,431000,634000,2017
A822C257-730B-E811-80C3-3863BB430E3F,11235,40.579912,-73.944925,0.5,"SFR,PERMANENT LIVING",A2,RR101,1,,22809,59871,82680,701000,1840000,2541000,2017
0E48AA57-730B-E811-80C3-3863BB430E3F,11235,40.590213,-73.944911,3.1,"SINGLE FAM RES,ATTAC",A5,RR101,1,,7203,18886,26089,156000,409000,565000,2017
008ACB57-730B-E811-80C3-3863BB430E3F,11235,40.590007,-73.944872,3,"SINGLE FAM RES,ATTAC",A5,RR101,1,,7222,18934,26156,156000,409000,565000,2017
C0FFA257-730B-E811-80C3-3863BB430E3F,11235,40.589948,-73.944861,3,"SINGLE FAM RES,ATTAC",A5,RR101,1,,7222,18934,26156,156000,409000,565000,2017
C0DED957-730B-E811-80C3-3863BB430E3F,11235,40.579028,-73.94485,1,"SFR,PERMANENT LIVING",A2,RR101,1,,43169,53693,96862,763000,949000,1712000,2017
C269B857-730B-E811-80C3-3863BB430E3F,11235,40.589888,-73.94485,3,"SINGLE FAM RES,ATTAC",A5,RR101,1,,7222,18934,26156,156000,409000,565000,2017
4C3FD057-730B-E811-80C3-3863BB430E3F,11235,40.589758,-73.944825,3,"SINGLE FAM RES,ATTAC",A5,RR101,1,,6651,14854,21505,180000,402000,582000,2017
5D35BD57-730B-E811-80C3-3863BB430E3F,11235,40.591464,-73.943972,3.4,"SINGLE FAM RES,ATTAC",A5,RR101,1,,7071,23804,30875,161000,542000,703000,2017
5231DC57-730B-E811-80C3-3863BB430E3F,11235,40.578428,-73.943785,1.7,"SFR,PERMANENT LIVING",A2,RR101,1,,17032,55128,72160,397000,1285000,1682000,2017
D0C2CB57-730B-E811-80C3-3863BB430E3F,11235,40.57823,-73.943739,1.9,"SFR,PERMANENT LIVING",A2,RR101,1,,21618,41918,63536,459000,890000,1349000,2017
AA8DCB57-730B-E811-80C3-3863BB430E3F,11235,40.578128,-73.94372,1.9,"SFR,PERMANENT LIVING",A2,RR101,1,,17755,55068,72823,414000,1284000,1698000,2017
C937B157-730B-E811-80C3-3863BB430E3F,11235,40.578128,-73.94372,1.9,"SFR,PERMANENT LIVING",A2,RR101,1,,17755,55068,72823,414000,1284000,1698000,2017
9A56C457-730B-E811-80C3-3863BB430E3F,11235,40.578152,-73.943347,2,"SFR,PERMANENT LIVING",A2,RR101,1,,38184,63504,101688,938000,1560000,2498000,2017
8D01AF57-730B-E811-80C3-3863BB430E3F,11235,40.58624,-73.942854,4.2,"SINGLE FAM RES,ATTAC",A5,RR101,1,,6595,20993,27588,164000,522000,686000,2017
0514C255-730B-E811-80C3-3863BB430E3F,11235,40.586185,-73.942813,4.1,"SFR,PERMANENT LIVING",A2,RR101,1,,5867,20896,26763,146000,520000,666000,2017
487CB857-730B-E811-80C3-3863BB430E3F,11235,40.586129,-73.942772,4.1,"SFR,PERMANENT LIVING",A2,RR101,1,,4323,17182,21505,117000,465000,582000,2017
0AD6BF57-730B-E811-80C3-3863BB430E3F,11235,40.579928,-73.942727,0.6,"SFR,PERMANENT LIVING",A2,RR101,1,,19725,34768,54493,455000,802000,1257000,2017
9FBFB357-730B-E811-80C3-3863BB430E3F,11235,40.589467,-73.942395,3,"SINGLE FAM RES, DETA",A1,RR101,1,,14850,17395,32245,315000,369000,684000,2017
0532BD57-730B-E811-80C3-3863BB430E3F,11235,40.58452,-73.941839,3.6,"SFR,PERMANENT LIVING",A2,RR101,1,,7675,17046,24721,163000,362000,525000,2017
F33EBD57-730B-E811-80C3-3863BB430E3F,11235,40.584794,-73.941589,4.9,"SFR,PERMANENT LIVING",A2,RR101,1,,9111,14893,24004,208000,340000,548000,2017
1EB8BF57-730B-E811-80C3-3863BB430E3F,11235,40.579158,-73.941076,1.4,"SFR,PERMANENT LIVING",A2,RR101,1,,10182,23236,33418,312000,712000,1024000,2017
5C3BD557-730B-E811-80C3-3863BB430E3F,11235,40.586907,-73.940492,3.6,"SFR,PERMANENT LIVING",A2,RR101,1,,4042,10288,14330,145000,369000,514000,2017
5D54BD57-730B-E811-80C3-3863BB430E3F,11235,40.579155,-73.940087,1.6,"SFR,PERMANENT LIVING",A2,RR101,1,,7740,19132,26872,231000,571000,802000,2017
3D709957-730B-E811-80C3-3863BB430E3F,11235,40.57908,-73.940075,1.7,"SFR,PERMANENT LIVING",A2,RR101,1,,5846,17196,23042,187000,550000,737000,2017
9E86AC57-730B-E811-80C3-3863BB430E3F,11235,40.578783,-73.94003,1.9,"SFR,PERMANENT LIVING",A2,RR101,1,,19983,5098,25081,392000,100000,492000,2017
C9739957-730B-E811-80C3-3863BB430E3F,11235,40.584482,-73.940007,2.2,"SFR,PERMANENT LIVING",A2,RR101,1,,3421,10760,14181,117000,368000,485000,2017
2BD7BA57-730B-E811-80C3-3863BB430E3F,11235,40.584732,-73.939959,3,"SFR,PERMANENT LIVING",A2,RR101,1,,4112,11293,15405,134000,368000,502000,2017
96CFBF57-730B-E811-80C3-3863BB430E3F,11235,40.584427,-73.939947,2.1,"SFR,PERMANENT LIVING",A2,RR101,1,,3349,10832,14181,115000,372000,487000,2017
A2A4CB57-730B-E811-80C3-3863BB430E3F,11235,40.584136,-73.939722,1.5,"SFR,PERMANENT LIVING",A2,RR101,1,,3428,11998,15426,116000,406000,522000,2017
B70BC255-730B-E811-80C3-3863BB430E3F,11235,40.580225,-73.939718,0.7,"SFR,PERMANENT LIVING",A2,RR101,1,,7070,15859,22929,354000,794000,1148000,2017
9452C457-730B-E811-80C3-3863BB430E3F,11235,40.579951,-73.939696,0.9,"SFR,PERMANENT LIVING",A2,RR101,1,,7955,23275,31230,324000,948000,1272000,2017
DA10C257-730B-E811-80C3-3863BB430E3F,11235,40.584454,-73.93967,2.2,"SFR,PERMANENT LIVING",A2,RR101,1,,5177,10946,16123,140000,296000,436000,2017
C8BED957-730B-E811-80C3-3863BB430E3F,11235,40.579608,-73.939669,1.4,"SFR,PERMANENT LIVING",A2,RR101,1,,7778,21960,29738,260000,734000,994000,2017
5B05B657-730B-E811-80C3-3863BB430E3F,11235,40.57954,-73.939663,1.5,"SFR,PERMANENT LIVING",A2,RR101,1,,6340,17304,23644,281000,767000,1048000,2017
92A5B857-730B-E811-80C3-3863BB430E3F,11235,40.579266,-73.939641,1.8,"SFR,PERMANENT LIVING",A2,RR101,1,,6901,25164,32065,297000,1083000,1380000,2017
3EB5A057-730B-E811-80C3-3863BB430E3F,11235,40.579129,-73.93963,1.8,"SFR,PERMANENT LIVING",A2,RR101,1,,6509,16779,23288,232000,598000,830000,2017
C45CC457-730B-E811-80C3-3863BB430E3F,11235,40.579059,-73.939624,1.8,"SFR,PERMANENT LIVING",A2,RR101,1,,7829,23224,31053,299000,887000,1186000,2017
D915C255-730B-E811-80C3-3863BB430E3F,11235,40.578989,-73.939619,1.8,"SFR,PERMANENT LIVING",A2,RR101,1,,5432,17750,23182,217000,709000,926000,2017
B288BF57-730B-E811-80C3-3863BB430E3F,11235,40.578715,-73.939597,2,"SFR,PERMANENT LIVING",A2,RR101,1,,12274,22360,34634,314000,572000,886000,2017
DC7FA557-730B-E811-80C3-3863BB430E3F,11235,40.584275,-73.939495,1.8,"SFR,PERMANENT LIVING",A2,RR101,1,,4901,10504,15405,126000,270000,396000,2017
0E8FC457-730B-E811-80C3-3863BB430E3F,11235,40.578551,-73.939164,2.3,"SFR,PERMANENT LIVING",A2,RR101,1,,7661,19211,26872,266000,667000,933000,2017
9DC6B357-730B-E811-80C3-3863BB430E3F,11235,40.578551,-73.939164,2.3,"SFR,PERMANENT LIVING",A2,RR101,1,,7661,19211,26872,266000,667000,933000,2017
5F5BBD57-730B-E811-80C3-3863BB430E3F,11235,40.580306,-73.939113,0.8,"SFR,PERMANENT LIVING",A2,RR101,1,,6590,14906,21496,256000,579000,835000,2017
3EE9C157-730B-E811-80C3-3863BB430E3F,11235,40.580096,-73.939103,1.1,"SFR,PERMANENT LIVING",A2,RR101,1,,7703,24328,32031,221000,698000,919000,2017
27DD9B57-730B-E811-80C3-3863BB430E3F,11235,40.579889,-73.939093,1.5,"SFR,PERMANENT LIVING",A2,RR101,1,,8172,13324,21496,257000,419000,676000,2017
6A79CB57-730B-E811-80C3-3863BB430E3F,11235,40.579546,-73.939075,1.9,"SFR,PERMANENT LIVING",A2,RR101,1,,5989,16583,22572,229000,634000,863000,2017
A081CB57-730B-E811-80C3-3863BB430E3F,11235,40.587061,-73.939067,2.7,"SFR,PERMANENT LIVING",A2,RR101,1,,9064,15629,24693,243000,419000,662000,2017
2976A557-730B-E811-80C3-3863BB430E3F,11235,40.578793,-73.93904,2.2,"SFR,PERMANENT LIVING",A2,RR101,1,,12737,16235,28972,375000,478000,853000,2017
8C14AF57-730B-E811-80C3-3863BB430E3F,11235,40.584729,-73.939039,3,"SFR,PERMANENT LIVING",A2,RR101,1,,4283,9329,13612,135000,294000,429000,2017
15D59B57-730B-E811-80C3-3863BB430E3F,11235,40.584956,-73.939029,3.9,"SFR,PERMANENT LIVING",A2,RR101,1,,5112,9702,14814,127000,241000,368000,2017
9097A057-730B-E811-80C3-3863BB430E3F,11235,40.58459,-73.938953,2.5,"SFR,PERMANENT LIVING",A2,RR101,1,,4509,8029,12538,132000,235000,367000,2017
C64FA557-730B-E811-80C3-3863BB430E3F,11235,40.584735,-73.938808,3,"SFR,PERMANENT LIVING",A2,RR101,1,,3659,8205,11864,99000,222000,321000,2017
3886BF57-730B-E811-80C3-3863BB430E3F,11235,40.584372,-73.938765,2,"SFR,PERMANENT LIVING",A2,RR101,1,,4537,8001,12538,131000,231000,362000,2017
52FCC157-730B-E811-80C3-3863BB430E3F,11235,40.58468,-73.938761,2.8,"SFR,PERMANENT LIVING",A2,RR101,1,,3706,9906,13612,107000,286000,393000,2017
FBFF9B57-730B-E811-80C3-3863BB430E3F,11235,40.584948,-73.938727,3.7,"SFR,PERMANENT LIVING",A2,RR101,1,,5227,6955,12182,121000,161000,282000,2017
BC01D557-730B-E811-80C3-3863BB430E3F,11235,40.580062,-73.938713,1.8,"SFR,PERMANENT LIVING",A2,RR101,1,,5739,15041,20780,240000,629000,869000,2017
E56DA557-730B-E811-80C3-3863BB430E3F,11235,40.580506,-73.938689,0.9,"SFR,PERMANENT LIVING",A2,RR101,1,,6582,18064,24646,231000,634000,865000,2017
8DD7BA57-730B-E811-80C3-3863BB430E3F,11235,40.584893,-73.93868,3.5,"SFR,PERMANENT LIVING",A2,RR101,1,,3213,8247,11460,83000,213000,296000,2017
003AD057-730B-E811-80C3-3863BB430E3F,11235,40.579303,-73.938677,2.3,"SFR,PERMANENT LIVING",A2,RR101,1,,8447,18519,26966,213000,467000,680000,2017
C53ABD57-730B-E811-80C3-3863BB430E3F,11235,40.579303,-73.938677,2.3,"SFR,PERMANENT LIVING",A2,RR101,1,,8447,18519,26966,213000,467000,680000,2017
0003C257-730B-E811-80C3-3863BB430E3F,11235,40.584262,-73.938671,1.8,"SFR,PERMANENT LIVING",A2,RR101,1,,3736,8802,12538,104000,245000,349000,2017
F2A7BF57-730B-E811-80C3-3863BB430E3F,11235,40.579166,-73.93867,2.3,"SFR,PERMANENT LIVING",A2,RR101,1,,6788,18293,25081,213000,574000,787000,2017
0A8BA057-730B-E811-80C3-3863BB430E3F,11235,40.584208,-73.938624,1.7,"SFR,PERMANENT LIVING",A2,RR101,1,,4388,8150,12538,119000,221000,340000,2017
8D66A557-730B-E811-80C3-3863BB430E3F,11235,40.584514,-73.938617,2.3,"SFR,PERMANENT LIVING",A2,RR101,1,,4460,9152,13612,115000,236000,351000,2017
AB0BB657-730B-E811-80C3-3863BB430E3F,11235,40.584785,-73.938587,3.1,"SFR,PERMANENT LIVING",A2,RR101,1,,3213,8247,11460,83000,213000,296000,2017
CC38DC57-730B-E811-80C3-3863BB430E3F,11235,40.584461,-73.938572,2.2,"SFR,PERMANENT LIVING",A2,RR101,1,,5472,8140,13612,119000,177000,296000,2017
8ACBCB57-730B-E811-80C3-3863BB430E3F,11235,40.584731,-73.93854,2.9,"SFR,PERMANENT LIVING",A2,RR101,1,,3213,8247,11460,83000,213000,296000,2017
E71EBD57-730B-E811-80C3-3863BB430E3F,11235,40.584405,-73.938524,2.1,"SFR,PERMANENT LIVING",A2,RR101,1,,3934,9678,13612,100000,246000,346000,2017
39EE9B57-730B-E811-80C3-3863BB430E3F,11235,40.584675,-73.938493,2.7,"SFR,PERMANENT LIVING",A2,RR101,1,,5280,3420,8700,88000,57000,145000,2017
4ADFCD57-730B-E811-80C3-3863BB430E3F,11235,40.58435,-73.938477,2,"SFR,PERMANENT LIVING",A2,RR101,1,,3934,9678,13612,100000,246000,346000,2017
02E6CD57-730B-E811-80C3-3863BB430E3F,11235,40.584868,-73.938429,3.2,"SFR,PERMANENT LIVING",A2,RR101,1,,3332,10998,14330,83000,274000,357000,2017
7F0EC255-730B-E811-80C3-3863BB430E3F,11235,40.584564,-73.938397,2.3,"SFR,PERMANENT LIVING",A2,RR101,1,,3058,8402,11460,83000,228000,311000,2017
63BF9B57-730B-E811-80C3-3863BB430E3F,11235,40.584241,-73.938383,1.7,"SFR,PERMANENT LIVING",A2,RR101,1,,4369,8527,12896,104000,203000,307000,2017
1CDCBF57-730B-E811-80C3-3863BB430E3F,11235,40.584455,-73.938303,2.1,"SFR,PERMANENT LIVING",A2,RR101,1,,4369,8527,12896,104000,203000,307000,2017
A22CC257-730B-E811-80C3-3863BB430E3F,11235,40.584401,-73.938257,2,"SFR,PERMANENT LIVING",A2,RR101,1,,4706,8549,13255,109000,198000,307000,2017
93EEAE57-730B-E811-80C3-3863BB430E3F,11235,40.585307,-73.938255,4.5,"SFR,PERMANENT LIVING",A2,RR101,1,,4751,12982,17733,116000,317000,433000,2017
D28BC457-730B-E811-80C3-3863BB430E3F,11235,40.584538,-73.938146,2.2,"SFR,PERMANENT LIVING",A2,RR101,1,,3493,10837,14330,88000,273000,361000,2017
C35CBD57-730B-E811-80C3-3863BB430E3F,11235,40.57975,-73.938121,2.6,"SINGLE FAM RES,ATTAC",A5,RR101,1,,12180,19560,31740,203000,326000,529000,2017
B537B157-730B-E811-80C3-3863BB430E3F,11235,40.584915,-73.938064,2.8,"SFR,PERMANENT LIVING",A2,RR101,1,,6182,14170,20352,130000,298000,428000,2017
6A8FBF57-730B-E811-80C3-3863BB430E3F,11235,40.585245,-73.938057,3.8,"SFR,PERMANENT LIVING",A2,RR101,1,,3837,9418,13255,99000,243000,342000,2017
0628C957-730B-E811-80C3-3863BB430E3F,11235,40.585164,-73.938042,3.5,"SFR,PERMANENT LIVING",A2,RR101,1,,5798,7098,12896,156000,191000,347000,2017
BC1DAA57-730B-E811-80C3-3863BB430E3F,11235,40.584373,-73.938004,1.8,"SFR,PERMANENT LIVING",A2,RR101,1,,3010,11147,14157,74000,274000,348000,2017
F8F0A257-730B-E811-80C3-3863BB430E3F,11235,40.584317,-73.937955,1.7,"SFR,PERMANENT LIVING",A2,RR101,1,,3824,10506,14330,99000,272000,371000,2017
FA84C457-730B-E811-80C3-3863BB430E3F,11235,40.585327,-73.937873,3.7,"SFR,PERMANENT LIVING",A2,RR101,1,,4227,7955,12182,110000,207000,317000,2017
8041D057-730B-E811-80C3-3863BB430E3F,11235,40.585312,-73.937789,3.4,"SFR,PERMANENT LIVING",A2,RR101,1,,2844,10768,13612,84000,318000,402000,2017
269BA057-730B-E811-80C3-3863BB430E3F,11235,40.584948,-73.937752,2.5,"SFR,PERMANENT LIVING",A2,RR101,1,,4044,8852,12896,111000,243000,354000,2017
52B6A057-730B-E811-80C3-3863BB430E3F,11235,40.585017,-73.937727,2.6,"SFR,PERMANENT LIVING",A2,RR101,1,,6540,6715,13255,186000,191000,377000,2017
ABC4B357-730B-E811-80C3-3863BB430E3F,11235,40.585289,-73.937683,3.1,"SFR,PERMANENT LIVING",A2,RR101,1,,3214,6021,9235,87000,163000,250000,2017
3A5AD757-730B-E811-80C3-3863BB430E3F,11235,40.585206,-73.937667,2.8,"SFR,PERMANENT LIVING",A2,RR101,1,,4257,10073,14330,131000,310000,441000,2017
5A3F9E57-730B-E811-80C3-3863BB430E3F,11235,40.584492,-73.93758,1.8,"SFR,PERMANENT LIVING",A2,RR101,1,,12179,8787,20966,237000,171000,408000,2017
01DD9B57-730B-E811-80C3-3863BB430E3F,11235,40.584616,-73.937566,2,"SFR,PERMANENT LIVING",A2,RR101,1,,5568,10555,16123,115000,218000,333000,2017
92EDBF57-730B-E811-80C3-3863BB430E3F,11235,40.585279,-73.937314,2.6,"SFR,PERMANENT LIVING",A2,RR101,1,,4147,9772,13919,87000,205000,292000,2017
C63FDC57-730B-E811-80C3-3863BB430E3F,11235,40.585214,-73.937301,2.5,"SFR,PERMANENT LIVING",A2,RR101,1,,4951,8913,13864,105000,189000,294000,2017
FC87A057-730B-E811-80C3-3863BB430E3F,11235,40.585148,-73.93729,2.4,"SFR,PERMANENT LIVING",A2,RR101,1,,4174,10184,14358,91000,222000,313000,2017
F41EAA57-730B-E811-80C3-3863BB430E3F,11235,40.585083,-73.937277,2.3,"SFR,PERMANENT LIVING",A2,RR101,1,,4670,9660,14330,102000,211000,313000,2017
B9C6B357-730B-E811-80C3-3863BB430E3F,11235,40.585018,-73.937265,2.3,"SFR,PERMANENT LIVING",A2,RR101,1,,3829,8709,12538,91000,207000,298000,2017
E2CDBF57-730B-E811-80C3-3863BB430E3F,11235,40.584952,-73.937253,2.2,"SFR,PERMANENT LIVING",A2,RR101,1,,4185,10145,14330,92000,223000,315000,2017
A4A2BF57-730B-E811-80C3-3863BB430E3F,11235,40.584819,-73.937228,2.1,"SFR,PERMANENT LIVING",A2,RR101,1,,5731,7881,13612,96000,132000,228000,2017
A668B857-730B-E811-80C3-3863BB430E3F,11235,40.584649,-73.937185,1.8,"SFR,PERMANENT LIVING",A2,RR101,1,,9106,8627,17733,171000,162000,333000,2017
2DDDB357-730B-E811-80C3-3863BB430E3F,11235,40.5853,-73.93713,2.5,"SFR,PERMANENT LIVING",A2,RR101,1,,3798,8948,12746,87000,205000,292000,2017
5B61A557-730B-E811-80C3-3863BB430E3F,11235,40.585234,-73.937117,2.4,"SFR,PERMANENT LIVING",A2,RR101,1,,5484,6698,12182,122000,149000,271000,2017
1FFDB557-730B-E811-80C3-3863BB430E3F,11235,40.585535,-73.937115,3.1,"SFR,PERMANENT LIVING",A2,RR101,1,,4776,7406,12182,129000,200000,329000,2017
821BC257-730B-E811-80C3-3863BB430E3F,11235,40.585104,-73.937093,2.3,"SFR,PERMANENT LIVING",A2,RR101,1,,7130,4254,11384,119000,71000,190000,2017
C2ECC157-730B-E811-80C3-3863BB430E3F,11235,40.585039,-73.937081,2.2,"SFR,PERMANENT LIVING",A2,RR101,1,,4112,8070,12182,107000,210000,317000,2017
FA5CB857-730B-E811-80C3-3863BB430E3F,11235,40.58484,-73.937044,2.1,"SFR,PERMANENT LIVING",A2,RR101,1,,5684,3410,9094,95000,57000,152000,2017
BA81A057-730B-E811-80C3-3863BB430E3F,11235,40.584627,-73.937035,1.8,"SFR,PERMANENT LIVING",A2,RR101,1,,3571,9325,12896,121000,316000,437000,2017
A726BD57-730B-E811-80C3-3863BB430E3F,11235,40.584172,-73.936929,1.1,"SFR,PERMANENT LIVING",A2,RR101,1,,10371,13121,23492,230000,291000,521000,2017
428AC457-730B-E811-80C3-3863BB430E3F,11235,40.585191,-73.936907,2.4,"SFR,PERMANENT LIVING",A2,RR101,1,,4426,7756,12182,113000,198000,311000,2017
91FAB557-730B-E811-80C3-3863BB430E3F,11235,40.585127,-73.936895,2.3,"SFR,PERMANENT LIVING",A2,RR101,1,,4461,8285,12746,112000,208000,320000,2017
2ADBCD57-730B-E811-80C3-3863BB430E3F,11235,40.584995,-73.936871,2.2,"SFR,PERMANENT LIVING",A2,RR101,1,,4232,7950,12182,107000,201000,308000,2017
C602D557-730B-E811-80C3-3863BB430E3F,11235,40.584619,-73.936859,1.7,"SFR,PERMANENT LIVING",A2,RR101,1,,4985,8270,13255,132000,219000,351000,2017
EE47AA57-730B-E811-80C3-3863BB430E3F,11235,40.584928,-73.936858,2.1,"SFR,PERMANENT LIVING",A2,RR101,1,,4334,7848,12182,111000,201000,312000,2017
AA7CD757-730B-E811-80C3-3863BB430E3F,11235,40.584169,-73.936828,1.1,"SFR,PERMANENT LIVING",A2,RR101,1,,11264,10958,22222,257000,250000,507000,2017
032BBD57-730B-E811-80C3-3863BB430E3F,11235,40.584629,-73.936768,1.7,"SFR,PERMANENT LIVING",A2,RR101,1,,5841,8489,14330,150000,218000,368000,2017
B4ADD257-730B-E811-80C3-3863BB430E3F,11235,40.585343,-73.936747,2.5,"SFR,PERMANENT LIVING",A2,RR101,1,,4239,13868,18107,92000,301000,393000,2017
AB1AB657-730B-E811-80C3-3863BB430E3F,11235,40.585212,-73.936723,2.3,"SFR,PERMANENT LIVING",A2,RR101,1,,4703,14885,19588,91000,288000,379000,2017
F11EBD57-730B-E811-80C3-3863BB430E3F,11235,40.585148,-73.936711,2.3,"SFR,PERMANENT LIVING",A2,RR101,1,,4703,14885,19588,91000,288000,379000,2017
1C9CBF57-730B-E811-80C3-3863BB430E3F,11235,40.585016,-73.936687,2.1,"SFR,PERMANENT LIVING",A2,RR101,1,,4103,12980,17083,92000,291000,383000,2017
32D9CB57-730B-E811-80C3-3863BB430E3F,11235,40.585016,-73.936687,2.1,"SFR,PERMANENT LIVING",A2,RR101,1,,4103,12980,17083,92000,291000,383000,2017
F5A0B357-730B-E811-80C3-3863BB430E3F,11235,40.584805,-73.936648,1.9,"SFR,PERMANENT LIVING",A2,RR101,1,,5529,10443,15972,126000,238000,364000,2017
D687BF57-730B-E811-80C3-3863BB430E3F,11235,40.584568,-73.936613,1.6,"SFR,PERMANENT LIVING",A2,RR101,1,,4432,10736,15168,97000,235000,332000,2017
088AAC57-730B-E811-80C3-3863BB430E3F,11235,40.58327,-73.93648,0.1,"SFR,PERMANENT LIVING",A2,RR101,1,,3835,9445,13280,93000,229000,322000,2017
FE2EAA57-730B-E811-80C3-3863BB430E3F,11235,40.58366,-73.936468,0.5,"SFR,PERMANENT LIVING",A2,RR101,1,,3349,6699,10048,71000,142000,213000,2017
7095CB57-730B-E811-80C3-3863BB430E3F,11235,40.583663,-73.936387,0.5,"SFR,PERMANENT LIVING",A2,RR101,1,,4970,10369,15339,93000,194000,287000,2017
77D1B357-730B-E811-80C3-3863BB430E3F,11235,40.58356,-73.936366,0.4,"SFR,PERMANENT LIVING",A2,RR101,1,,2885,8238,11123,69000,197000,266000,2017
F5D49B57-730B-E811-80C3-3863BB430E3F,11235,40.583494,-73.936363,0.3,"SFR,PERMANENT LIVING",A2,RR101,1,,2780,7533,10313,69000,187000,256000,2017
244CC457-730B-E811-80C3-3863BB430E3F,11234,40.618511,-73.936308,5.5,"SFR,PERMANENT LIVING",A2,RR101,1,,15463,19932,35395,301000,388000,689000,2017
3C49D057-730B-E811-80C3-3863BB430E3F,11235,40.583698,-73.93628,0.5,"SFR,PERMANENT LIVING",A2,RR101,1,,3613,7105,10718,90000,177000,267000,2017
42DACD57-730B-E811-80C3-3863BB430E3F,11235,40.583634,-73.936276,0.5,"SFR,PERMANENT LIVING",A2,RR101,1,,2762,7485,10247,69000,187000,256000,2017
A47CAC57-730B-E811-80C3-3863BB430E3F,11235,40.58351,-73.93627,0.3,"SFR,PERMANENT LIVING",A2,RR101,1,,2780,7533,10313,69000,187000,256000,2017
E494A057-730B-E811-80C3-3863BB430E3F,11235,40.583638,-73.936095,0.5,"SFR,PERMANENT LIVING",A2,RR101,1,,3013,8177,11190,70000,190000,260000,2017
C041AA57-730B-E811-80C3-3863BB430E3F,11235,40.583454,-73.936085,0.3,"SFR,PERMANENT LIVING",A2,RR101,1,,3638,8429,12067,82000,190000,272000,2017
42BDA057-730B-E811-80C3-3863BB430E3F,11235,40.583709,-73.93596,0.6,"SFR,PERMANENT LIVING",A2,RR101,1,,4035,7425,11460,94000,173000,267000,2017
BF52B157-730B-E811-80C3-3863BB430E3F,11234,40.609412,-73.935958,4.1,"SFR,PERMANENT LIVING",A2,RR101,1,,6806,20092,26898,146000,431000,577000,2017
A9C5BA57-730B-E811-80C3-3863BB430E3F,11235,40.583644,-73.935957,0.5,"SFR,PERMANENT LIVING",A2,RR101,1,,3239,8760,11999,71000,192000,263000,2017
1F63A557-730B-E811-80C3-3863BB430E3F,11235,40.583583,-73.935954,0.4,"SFR,PERMANENT LIVING",A2,RR101,1,,3239,8760,11999,71000,192000,263000,2017
9EFED457-730B-E811-80C3-3863BB430E3F,11235,40.583459,-73.935947,0.3,"SFR,PERMANENT LIVING",A2,RR101,1,,3900,9178,13078,82000,193000,275000,2017
E1F4AE57-730B-E811-80C3-3863BB430E3F,11234,40.60945,-73.935898,4.1,"SFR,PERMANENT LIVING",A2,RR101,1,,6806,20092,26898,146000,431000,577000,2017
E82BDC57-730B-E811-80C3-3863BB430E3F,11234,40.609489,-73.935838,4.1,"SFR,PERMANENT LIVING",A2,RR101,1,,6806,20092,26898,146000,431000,577000,2017
B243C457-730B-E811-80C3-3863BB430E3F,11234,40.609528,-73.935776,4.1,"SFR,PERMANENT LIVING",A2,RR101,1,,6806,20092,26898,146000,431000,577000,2017
8468B857-730B-E811-80C3-3863BB430E3F,11235,40.583653,-73.93576,0.5,"SFR,PERMANENT LIVING",A2,RR101,1,,3839,9036,12875,82000,193000,275000,2017
BEFBD457-730B-E811-80C3-3863BB430E3F,11234,40.624444,-73.93576,4.6,"SINGLE FAM RES,ATTAC",A5,RR101,1,,14321,15040,29361,259000,272000,531000,2017
EE05A357-730B-E811-80C3-3863BB430E3F,11235,40.583592,-73.935759,0.4,"SFR,PERMANENT LIVING",A2,RR101,1,,3413,8337,11750,79000,193000,272000,2017
D54AB157-730B-E811-80C3-3863BB430E3F,11234,40.609114,-73.935759,4.1,"SFR,PERMANENT LIVING",A2,RR101,1,,6448,20450,26898,146000,463000,609000,2017
586CCB57-730B-E811-80C3-3863BB430E3F,11235,40.583405,-73.935755,0.2,"SFR,PERMANENT LIVING",A2,RR101,1,,3601,9072,12673,77000,194000,271000,2017
64CDBF57-730B-E811-80C3-3863BB430E3F,11235,40.583339,-73.935754,0.2,"SFR,PERMANENT LIVING",A2,RR101,1,,3356,8591,11947,75000,192000,267000,2017
3412C257-730B-E811-80C3-3863BB430E3F,11234,40.609569,-73.935714,4.1,"SFR,PERMANENT LIVING",A2,RR101,1,,6806,20092,26898,146000,431000,577000,2017
E4D6CB57-730B-E811-80C3-3863BB430E3F,11234,40.609069,-73.935708,4.1,"SFR,PERMANENT LIVING",A2,RR101,1,,6448,20450,26898,146000,463000,609000,2017
F35ABD57-730B-E811-80C3-3863BB430E3F,11234,40.609069,-73.935708,4.1,"SFR,PERMANENT LIVING",A2,RR101,1,,6448,20450,26898,146000,463000,609000,2017
FCCDCB57-730B-E811-80C3-3863BB430E3F,11234,40.609024,-73.935658,4.1,"SFR,PERMANENT LIVING",A2,RR101,1,,6448,20450,26898,146000,463000,609000,2017
E811AA57-730B-E811-80C3-3863BB430E3F,11234,40.608978,-73.935607,4.1,"SFR,PERMANENT LIVING",A2,RR101,1,,6448,20450,26898,146000,463000,609000,2017
EB08AF57-730B-E811-80C3-3863BB430E3F,11234,40.609399,-73.935595,4.1,"SFR,PERMANENT LIVING",A2,RR101,1,,10198,20258,30456,222000,441000,663000,2017
550CC255-730B-E811-80C3-3863BB430E3F,11234,40.608918,-73.935541,4,"SFR,PERMANENT LIVING",A2,RR101,1,,8758,21698,30456,222000,550000,772000,2017
207CD757-730B-E811-80C3-3863BB430E3F,11234,40.60934,-73.93553,4,"SFR,PERMANENT LIVING",A2,RR101,1,,8203,20226,28429,174000,429000,603000,2017
D4F3A257-730B-E811-80C3-3863BB430E3F,11234,40.609295,-73.935479,4,"SFR,PERMANENT LIVING",A2,RR101,1,,4911,15987,20898,133000,433000,566000,2017
2206D557-730B-E811-80C3-3863BB430E3F,11234,40.608857,-73.935473,4,"SFR,PERMANENT LIVING",A2,RR101,1,,7237,23301,30538,164000,528000,692000,2017
9256AA57-730B-E811-80C3-3863BB430E3F,11234,40.609249,-73.935429,4,"SFR,PERMANENT LIVING",A2,RR101,1,,6806,20092,26898,146000,431000,577000,2017
0A2CC957-730B-E811-80C3-3863BB430E3F,11234,40.608762,-73.935367,3.9,"SFR,PERMANENT LIVING",A2,RR101,1,,7976,23304,31280,166000,485000,651000,2017
BE8CC457-730B-E811-80C3-3863BB430E3F,11234,40.609158,-73.935327,4,"SFR,PERMANENT LIVING",A2,RR101,1,,6806,20092,26898,146000,431000,577000,2017
761CDC57-730B-E811-80C3-3863BB430E3F,11234,40.608716,-73.935316,3.9,"SFR,PERMANENT LIVING",A2,RR101,1,,8156,23461,31617,170000,489000,659000,2017
68C2A057-730B-E811-80C3-3863BB430E3F,11234,40.609099,-73.935261,4,"SFR,PERMANENT LIVING",A2,RR101,1,,9957,19781,29738,222000,441000,663000,2017
2D22BD57-730B-E811-80C3-3863BB430E3F,11234,40.608469,-73.93504,3.9,"SINGLE FAM RES, DETA",A1,RR101,1,,7787,21977,29764,163000,460000,623000,2017
2441D057-730B-E811-80C3-3863BB430E3F,11234,40.608329,-73.934884,3.9,"SFR,PERMANENT LIVING",A2,RR101,1,,7232,22565,29797,158000,493000,651000,2017
6115C255-730B-E811-80C3-3863BB430E3F,11234,40.608238,-73.934784,3.8,"SINGLE FAM RES,ATTAC",A5,RR101,1,,6995,22195,29190,156000,495000,651000,2017
5860D757-730B-E811-80C3-3863BB430E3F,11234,40.632288,-73.933865,7.4,"SINGLE FAM RES,ATTAC",A5,RR101,1,,7824,15453,23277,161000,318000,479000,2017
1A52AA57-730B-E811-80C3-3863BB430E3F,11234,40.632167,-73.933852,7.3,"SINGLE FAM RES,ATTAC",A5,RR101,1,,7792,15485,23277,158000,314000,472000,2017
FE3EDC57-730B-E811-80C3-3863BB430E3F,11234,40.632106,-73.933845,7.3,"SINGLE FAM RES,ATTAC",A5,RR101,1,,9142,16685,25827,183000,334000,517000,2017
EBDBBA57-730B-E811-80C3-3863BB430E3F,11234,40.632323,-73.933292,7.3,"SINGLE FAM RES,ATTAC",A5,RR101,1,,7950,16395,24345,161000,332000,493000,2017
D641D557-730B-E811-80C3-3863BB430E3F,11234,40.632142,-73.933273,7.2,"SINGLE FAM RES,ATTAC",A5,RR101,1,,7149,17077,24226,157000,375000,532000,2017
F0E2CD57-730B-E811-80C3-3863BB430E3F,11234,40.632142,-73.933273,7.2,"SINGLE FAM RES,ATTAC",A5,RR101,1,,7149,17077,24226,157000,375000,532000,2017
E069D757-730B-E811-80C3-3863BB430E3F,11234,40.60784,-73.933109,3.8,"SFR,PERMANENT LIVING",A2,RR101,1,,6890,21087,27977,149000,456000,605000,2017
942AD557-730B-E811-80C3-3863BB430E3F,11234,40.632164,-73.932913,7.2,"SINGLE FAM RES,ATTAC",A5,RR101,1,,8955,17088,26043,185000,353000,538000,2017
B818AF57-730B-E811-80C3-3863BB430E3F,11234,40.607499,-73.932728,3.6,"SINGLE FAM RES,ATTAC",A5,RR101,1,,7393,20448,27841,175000,484000,659000,2017
2E9FD257-730B-E811-80C3-3863BB430E3F,11234,40.621489,-73.932708,4.6,"SFR,PERMANENT LIVING",A2,RR101,1,,7578,12286,19864,169000,274000,443000,2017
AABAD957-730B-E811-80C3-3863BB430E3F,11234,40.620342,-73.932589,5.1,"SFR,PERMANENT LIVING",A2,RR101,1,,7862,14602,22464,140000,260000,400000,2017
B652D057-730B-E811-80C3-3863BB430E3F,11234,40.607355,-73.932567,3.6,"SFR,PERMANENT LIVING",A2,RR101,1,,9428,22117,31545,159000,373000,532000,2017
5497BF57-730B-E811-80C3-3863BB430E3F,11234,40.626775,-73.932348,5.8,"SINGLE FAM RES,ATTAC",A5,RR101,1,,10129,19964,30093,172000,339000,511000,2017
AB4BBD57-730B-E811-80C3-3863BB430E3F,11234,40.612676,-73.932256,4.3,"SFR,PERMANENT LIVING",A2,RR101,1,,4926,18804,23730,131000,500000,631000,2017
14A7CB57-730B-E811-80C3-3863BB430E3F,11234,40.607071,-73.93225,3.6,"SFR,PERMANENT LIVING",A2,RR101,1,,7161,19805,26966,175000,484000,659000,2017
BC81A057-730B-E811-80C3-3863BB430E3F,11234,40.620488,-73.932035,5.1,"SFR,PERMANENT LIVING",A2,RR101,1,,6419,14101,20520,122000,268000,390000,2017
B473B857-730B-E811-80C3-3863BB430E3F,11234,40.60638,-73.931481,3.3,"SINGLE FAM RES,ATTAC",A5,RR101,1,,5767,18906,24673,133000,436000,569000,2017
4A47A557-730B-E811-80C3-3863BB430E3F,11234,40.606334,-73.931431,3.3,"SINGLE FAM RES,ATTAC",A5,RR101,1,,5704,18700,24404,133000,436000,569000,2017
EFDDBA57-730B-E811-80C3-3863BB430E3F,11234,40.61455,-73.931419,4.2,"SFR,PERMANENT LIVING",A2,RR101,1,,12459,23877,36336,239000,458000,697000,2017
686FD757-730B-E811-80C3-3863BB430E3F,11234,40.606289,-73.93138,3.3,"SINGLE FAM RES,ATTAC",A5,RR101,1,,5751,18855,24606,133000,436000,569000,2017
7EF0CD57-730B-E811-80C3-3863BB430E3F,11234,40.607415,-73.931358,3.6,"SFR,PERMANENT LIVING",A2,RR101,1,,6920,20855,27775,148000,446000,594000,2017
4E82B857-730B-E811-80C3-3863BB430E3F,11234,40.606242,-73.931328,3.3,"SINGLE FAM RES,ATTAC",A5,RR101,1,,5736,18803,24539,133000,436000,569000,2017
910DB657-730B-E811-80C3-3863BB430E3F,11234,40.614466,-73.931325,4.2,"SFR,PERMANENT LIVING",A2,RR101,1,,13851,28755,42606,250000,519000,769000,2017
E0DECB57-730B-E811-80C3-3863BB430E3F,11234,40.614403,-73.931255,4.1,"SFR,PERMANENT LIVING",A2,RR101,1,,7584,17898,25482,150000,354000,504000,2017
C270AC57-730B-E811-80C3-3863BB430E3F,11234,40.60615,-73.931225,3.3,"SINGLE FAM RES,ATTAC",A5,RR101,1,,5704,18700,24404,133000,436000,569000,2017
6979A557-730B-E811-80C3-3863BB430E3F,11234,40.630916,-73.931197,6.7,"SINGLE FAM RES, DETA",A1,RR101,1,,8141,10438,18579,163000,209000,372000,2017
0707C255-730B-E811-80C3-3863BB430E3F,11234,40.613193,-73.931133,4.3,"SFR,PERMANENT LIVING",A2,RR101,1,,8974,27774,36748,200000,619000,819000,2017
E8D1CD57-730B-E811-80C3-3863BB430E3F,11234,40.609816,-73.931063,4.2,"SINGLE FAM RES, DETA",A1,RR101,1,,5052,17599,22651,124000,432000,556000,2017
28A8CB57-730B-E811-80C3-3863BB430E3F,11234,40.606,-73.931058,3.2,"SINGLE FAM RES,ATTAC",A5,RR101,1,,5688,18648,24336,133000,436000,569000,2017
47CB9B57-730B-E811-80C3-3863BB430E3F,11234,40.631515,-73.930897,6.7,"SINGLE FAM RES,ATTAC",A5,RR101,1,,7821,20710,28531,159000,421000,580000,2017
BE86C457-730B-E811-80C3-3863BB430E3F,11234,40.631239,-73.930866,6.6,"SINGLE FAM RES,ATTAC",A5,RR101,1,,9846,19350,29196,202000,397000,599000,2017
0234D557-730B-E811-80C3-3863BB430E3F,11234,40.631032,-73.930844,6.6,"SINGLE FAM RES,ATTAC",A5,RR101,1,,6569,18158,24727,140000,387000,527000,2017
5D99B357-730B-E811-80C3-3863BB430E3F,11234,40.630963,-73.930836,6.6,"SINGLE FAM RES,ATTAC",A5,RR101,1,,9779,20411,30190,195000,407000,602000,2017
2AF8C157-730B-E811-80C3-3863BB430E3F,11234,40.60577,-73.930801,3.1,"SINGLE FAM RES,ATTAC",A5,RR101,1,,5575,17481,23056,133000,417000,550000,2017
E62FD057-730B-E811-80C3-3863BB430E3F,11234,40.617055,-73.930721,4.3,"SFR,PERMANENT LIVING",A2,RR101,1,,15720,22920,38640,262000,382000,644000,2017
D0DFAE57-730B-E811-80C3-3863BB430E3F,11234,40.629237,-73.930646,6.2,"SINGLE FAM RES,ATTAC",A5,RR101,1,,7870,16514,24384,163000,342000,505000,2017
9254D057-730B-E811-80C3-3863BB430E3F,11234,40.610861,-73.930374,4.3,"SFR,PERMANENT LIVING",A2,RR101,1,,14680,24560,39240,266000,445000,711000,2017
C8B6A057-730B-E811-80C3-3863BB430E3F,11234,40.632012,-73.930367,6.3,"SINGLE FAM RES,ATTAC",A5,RR101,1,,6641,16439,23080,143000,354000,497000,2017
C620D557-730B-E811-80C3-3863BB430E3F,11234,40.631944,-73.93036,6.3,"SINGLE FAM RES,ATTAC",A5,RR101,1,,7176,18204,25380,149000,378000,527000,2017
E8EBBF57-730B-E811-80C3-3863BB430E3F,11234,40.631813,-73.930346,6.4,"SINGLE FAM RES,ATTAC",A5,RR101,1,,7082,18298,25380,149000,385000,534000,2017
7312B657-730B-E811-80C3-3863BB430E3F,11234,40.631742,-73.930338,6.4,"SINGLE FAM RES,ATTAC",A5,RR101,1,,9420,18182,27602,172000,332000,504000,2017
C0A3B857-730B-E811-80C3-3863BB430E3F,11234,40.631742,-73.930338,6.4,"SINGLE FAM RES,ATTAC",A5,RR101,1,,9420,18182,27602,172000,332000,504000,2017
C2B5A057-730B-E811-80C3-3863BB430E3F,11234,40.631606,-73.930323,6.4,"SINGLE FAM RES,ATTAC",A5,RR101,1,,8036,16771,24807,161000,336000,497000,2017
3FB7B357-730B-E811-80C3-3863BB430E3F,11234,40.63154,-73.930316,6.5,"SINGLE FAM RES,ATTAC",A5,RR101,1,,8740,17801,26541,163000,332000,495000,2017
CCA9CB57-730B-E811-80C3-3863BB430E3F,11234,40.629711,-73.930121,6.2,"SINGLE FAM RES,ATTAC",A5,RR101,1,,6692,18364,25056,133000,365000,498000,2017
8E8FBF57-730B-E811-80C3-3863BB430E3F,11234,40.62959,-73.930108,6.2,"SINGLE FAM RES,ATTAC",A5,RR101,1,,6711,18417,25128,133000,365000,498000,2017
59F8B557-730B-E811-80C3-3863BB430E3F,11234,40.607739,-73.93006,3.5,"SFR,PERMANENT LIVING",A2,RR101,1,,9991,24744,34735,214000,530000,744000,2017
2816C957-730B-E811-80C3-3863BB430E3F,11234,40.629065,-73.930052,6.1,"SINGLE FAM RES,ATTAC",A5,RR101,1,,8615,17926,26541,173000,360000,533000,2017
C0D3D957-730B-E811-80C3-3863BB430E3F,11234,40.628826,-73.930027,6,"SINGLE FAM RES,ATTAC",A5,RR101,1,,7139,18573,25712,148000,385000,533000,2017
6121BD57-730B-E811-80C3-3863BB430E3F,11234,40.628758,-73.93002,6,"SINGLE FAM RES,ATTAC",A5,RR101,1,,8138,19232,27370,168000,397000,565000,2017
8599B357-730B-E811-80C3-3863BB430E3F,11234,40.632017,-73.930006,6.3,"SINGLE FAM RES,ATTAC",A5,RR101,1,,7594,17735,25329,149000,348000,497000,2017
8DC89B57-730B-E811-80C3-3863BB430E3F,11234,40.628617,-73.930005,6,"SINGLE FAM RES,ATTAC",A5,RR101,1,,8856,18016,26872,175000,356000,531000,2017
50BDA057-730B-E811-80C3-3863BB430E3F,11234,40.631952,-73.929999,6.3,"SINGLE FAM RES,ATTAC",A5,RR101,1,,7681,17257,24938,146000,328000,474000,2017
9964BD57-730B-E811-80C3-3863BB430E3F,11234,40.628556,-73.929998,5.9,"SINGLE FAM RES,ATTAC",A5,RR101,1,,8856,18016,26872,175000,356000,531000,2017
5ADCCB57-730B-E811-80C3-3863BB430E3F,11234,40.628436,-73.929986,5.9,"SINGLE FAM RES,ATTAC",A5,RR101,1,,7456,17592,25048,153000,361000,514000,2017
CA82A557-730B-E811-80C3-3863BB430E3F,11234,40.63169,-73.929971,6.3,"SINGLE FAM RES,ATTAC",A5,RR101,1,,8817,16661,25478,172000,325000,497000,2017
48EFA257-730B-E811-80C3-3863BB430E3F,11234,40.631559,-73.929957,6.3,"SINGLE FAM RES,ATTAC",A5,RR101,1,,9034,16476,25510,176000,321000,497000,2017
58CBD957-730B-E811-80C3-3863BB430E3F,11234,40.628979,-73.929679,6,"SINGLE FAM RES,ATTAC",A5,RR101,1,,6757,18291,25048,133000,360000,493000,2017
C418AF57-730B-E811-80C3-3863BB430E3F,11234,40.628979,-73.929679,6,"SINGLE FAM RES,ATTAC",A5,RR101,1,,6757,18291,25048,133000,360000,493000,2017
08A1D257-730B-E811-80C3-3863BB430E3F,11234,40.605696,-73.929678,3,"SFR,PERMANENT LIVING",A2,RR101,1,,7967,19336,27303,171000,415000,586000,2017
5ED6CD57-730B-E811-80C3-3863BB430E3F,11234,40.628798,-73.92966,6,"SINGLE FAM RES,ATTAC",A5,RR101,1,,6533,17685,24218,133000,360000,493000,2017
A4EDC157-730B-E811-80C3-3863BB430E3F,11234,40.628738,-73.929654,6,"SINGLE FAM RES,ATTAC",A5,RR101,1,,6757,18291,25048,133000,360000,493000,2017
1574A557-730B-E811-80C3-3863BB430E3F,11234,40.628679,-73.929647,6,"SINGLE FAM RES,ATTAC",A5,RR101,1,,5995,16227,22222,133000,360000,493000,2017
C67BAC57-730B-E811-80C3-3863BB430E3F,11234,40.628611,-73.92964,6,"SINGLE FAM RES,ATTAC",A5,RR101,1,,9099,19432,28531,177000,378000,555000,2017
22F9C157-730B-E811-80C3-3863BB430E3F,11234,40.605738,-73.929613,3,"SFR,PERMANENT LIVING",A2,RR101,1,,6046,19301,25347,135000,431000,566000,2017
306ED757-730B-E811-80C3-3863BB430E3F,11234,40.605777,-73.929552,3,"SFR,PERMANENT LIVING",A2,RR101,1,,6062,19353,25415,135000,431000,566000,2017
8E92D257-730B-E811-80C3-3863BB430E3F,11234,40.605815,-73.929492,3,"SFR,PERMANENT LIVING",A2,RR101,1,,6171,19513,25684,136000,430000,566000,2017
F5BBB357-730B-E811-80C3-3863BB430E3F,11234,40.632193,-73.929447,6.2,"SINGLE FAM RES,ATTAC",A5,RR101,1,,7514,16984,24498,146000,330000,476000,2017
B518B657-730B-E811-80C3-3863BB430E3F,11234,40.607187,-73.929445,3.3,"SINGLE FAM RES,ATTAC",A5,RR101,1,,13542,19298,32840,247000,352000,599000,2017
6C0CD557-730B-E811-80C3-3863BB430E3F,11234,40.632127,-73.92944,6.2,"SINGLE FAM RES,ATTAC",A5,RR101,1,,9030,16350,25380,169000,306000,475000,2017
22CDA057-730B-E811-80C3-3863BB430E3F,11234,40.631997,-73.929426,6.2,"SINGLE FAM RES,ATTAC",A5,RR101,1,,7959,17586,25545,148000,327000,475000,2017
C2C5A057-730B-E811-80C3-3863BB430E3F,11234,40.631931,-73.929419,6.2,"SINGLE FAM RES,ATTAC",A5,RR101,1,,7327,16560,23887,146000,330000,476000,2017
58359E57-730B-E811-80C3-3863BB430E3F,11234,40.631799,-73.929405,6.2,"SINGLE FAM RES,ATTAC",A5,RR101,1,,7514,16984,24498,146000,330000,476000,2017
5218AA57-730B-E811-80C3-3863BB430E3F,11234,40.605891,-73.929374,3.1,"SFR,PERMANENT LIVING",A2,RR101,1,,6018,20003,26021,139000,462000,601000,2017
4F3BBD57-730B-E811-80C3-3863BB430E3F,11234,40.617293,-73.929372,4.3,"SFR,PERMANENT LIVING",A2,RR101,1,,12086,14426,26512,248000,296000,544000,2017
6A7FA557-730B-E811-80C3-3863BB430E3F,11234,40.605933,-73.929309,3.1,"SFR,PERMANENT LIVING",A2,RR101,1,,6328,19627,25955,138000,428000,566000,2017
5B3AB157-730B-E811-80C3-3863BB430E3F,11234,40.607751,-73.929233,3.3,"SFR,PERMANENT LIVING",A2,RR101,1,,8440,20885,29325,158000,391000,549000,2017
00E4A257-730B-E811-80C3-3863BB430E3F,11234,40.606995,-73.929232,3.2,"SFR,PERMANENT LIVING",A2,RR101,1,,8186,21192,29378,158000,409000,567000,2017
D47BA557-730B-E811-80C3-3863BB430E3F,11234,40.606018,-73.929176,3.1,"SFR,PERMANENT LIVING",A2,RR101,1,,7945,18818,26763,171000,405000,576000,2017
BC87CB57-730B-E811-80C3-3863BB430E3F,11234,40.606939,-73.929169,3.2,"SFR,PERMANENT LIVING",A2,RR101,1,,9717,23962,33679,221000,545000,766000,2017
F42AC957-730B-E811-80C3-3863BB430E3F,11234,40.628634,-73.929062,5.9,"SFR,PERMANENT LIVING",A2,RR101,1,,7345,20587,27932,147000,412000,559000,2017
1814AA57-730B-E811-80C3-3863BB430E3F,11234,40.628514,-73.92905,5.8,"SFR,PERMANENT LIVING",A2,RR101,1,,7445,20487,27932,149000,410000,559000,2017
AB23BD57-730B-E811-80C3-3863BB430E3F,11234,40.628445,-73.929043,5.8,"SFR,PERMANENT LIVING",A2,RR101,1,,9660,19370,29030,200000,401000,601000,2017
BE5CB857-730B-E811-80C3-3863BB430E3F,11234,40.607556,-73.929017,3.3,"SFR,PERMANENT LIVING",A2,RR101,1,,10642,20964,31606,200000,394000,594000,2017
C8E7BF57-730B-E811-80C3-3863BB430E3F,11234,40.609615,-73.928855,3.9,"SFR,PERMANENT LIVING",A2,RR101,1,,7152,21364,28516,153000,457000,610000,2017
3C17C257-730B-E811-80C3-3863BB430E3F,11234,40.625345,-73.928764,4.9,"SFR,PERMANENT LIVING",A2,RR101,1,,10244,22876,33120,176000,393000,569000,2017
84E2BF57-730B-E811-80C3-3863BB430E3F,11235,40.586098,-73.928706,1.6,"SFR,PERMANENT LIVING",A2,RR101,1,,8104,8484,16588,149000,156000,305000,2017
DA9ED257-730B-E811-80C3-3863BB430E3F,11234,40.615471,-73.928604,4.1,"SFR,PERMANENT LIVING",A2,RR101,1,,11470,19136,30606,196000,327000,523000,2017
8E5ED757-730B-E811-80C3-3863BB430E3F,11234,40.610216,-73.928292,4,"SFR,PERMANENT LIVING",A2,RR101,1,,22642,23537,46179,455000,473000,928000,2017
E841DC57-730B-E811-80C3-3863BB430E3F,11234,40.619996,-73.928147,5,"SINGLE FAM RES,ATTAC",A5,RR101,1,,7915,20054,27969,148000,375000,523000,2017
FCDFCD57-730B-E811-80C3-3863BB430E3F,11234,40.619936,-73.928141,5,"SINGLE FAM RES,ATTAC",A5,RR101,1,,7808,20161,27969,146000,377000,523000,2017
E096B857-730B-E811-80C3-3863BB430E3F,11234,40.619877,-73.928134,5,"SINGLE FAM RES,ATTAC",A5,RR101,1,,7540,20429,27969,141000,382000,523000,2017
3BE19B57-730B-E811-80C3-3863BB430E3F,11234,40.619816,-73.928128,5,"SINGLE FAM RES,ATTAC",A5,RR101,1,,7861,20108,27969,147000,376000,523000,2017
EE81B857-730B-E811-80C3-3863BB430E3F,11234,40.619635,-73.928108,4.9,"SINGLE FAM RES,ATTAC",A5,RR101,1,,7861,20108,27969,147000,376000,523000,2017
3D3FB157-730B-E811-80C3-3863BB430E3F,11234,40.619517,-73.928096,4.9,"SINGLE FAM RES,ATTAC",A5,RR101,1,,7808,20161,27969,146000,377000,523000,2017
8E5BC457-730B-E811-80C3-3863BB430E3F,11234,40.619395,-73.928082,4.9,"SINGLE FAM RES,ATTAC",A5,RR101,1,,7968,20001,27969,149000,374000,523000,2017
EEB6CB57-730B-E811-80C3-3863BB430E3F,11234,40.628349,-73.927685,5.5,"SFR,PERMANENT LIVING",A2,RR101,1,,15968,14166,30134,319000,283000,602000,2017
D8D3CD57-730B-E811-80C3-3863BB430E3F,11234,40.634564,-73.927673,4.7,"SINGLE FAM RES,ATTAC",A5,RR101,1,,7800,14520,22320,130000,242000,372000,2017
2AC6CB57-730B-E811-80C3-3863BB430E3F,11234,40.63021,-73.92765,5.9,"SFR,PERMANENT LIVING",A2,RR101,1,,11447,18080,29527,214000,338000,552000,2017
DB69BD57-730B-E811-80C3-3863BB430E3F,11234,40.634329,-73.927648,5,"SINGLE FAM RES,ATTAC",A5,RR101,1,,7800,14580,22380,130000,243000,373000,2017
6ECAA057-730B-E811-80C3-3863BB430E3F,11234,40.63421,-73.927636,5,"SINGLE FAM RES,ATTAC",A5,RR101,1,,7800,14580,22380,130000,243000,373000,2017
2283A057-730B-E811-80C3-3863BB430E3F,11234,40.634151,-73.927629,5,"SINGLE FAM RES,ATTAC",A5,RR101,1,,7860,14520,22380,131000,242000,373000,2017
38E7BF57-730B-E811-80C3-3863BB430E3F,11234,40.634035,-73.927617,5,"SINGLE FAM RES,ATTAC",A5,RR101,1,,7860,14520,22380,131000,242000,373000,2017
9AB2D257-730B-E811-80C3-3863BB430E3F,11234,40.633832,-73.927595,5.2,"SINGLE FAM RES,ATTAC",A5,RR101,1,,10080,12000,22080,168000,200000,368000,2017
BDFD9B57-730B-E811-80C3-3863BB430E3F,11234,40.633774,-73.927589,5.3,"SINGLE FAM RES,ATTAC",A5,RR101,1,,7860,14520,22380,131000,242000,373000,2017
0ECDCD57-730B-E811-80C3-3863BB430E3F,11234,40.633715,-73.927583,5.4,"SINGLE FAM RES,ATTAC",A5,RR101,1,,7920,14460,22380,132000,241000,373000,2017
921CDC57-730B-E811-80C3-3863BB430E3F,11234,40.633656,-73.927577,5.4,"SINGLE FAM RES,ATTAC",A5,RR101,1,,7373,16845,24218,130000,297000,427000,2017
29ECAE57-730B-E811-80C3-3863BB430E3F,11234,40.633539,-73.927564,5.6,"SINGLE FAM RES,ATTAC",A5,RR101,1,,7924,14134,22058,134000,239000,373000,2017
40D5BF57-730B-E811-80C3-3863BB430E3F,11234,40.633481,-73.927558,5.6,"SINGLE FAM RES,ATTAC",A5,RR101,1,,8040,14160,22200,134000,236000,370000,2017
3CF0A257-730B-E811-80C3-3863BB430E3F,11234,40.633422,-73.927552,5.7,"SINGLE FAM RES,ATTAC",A5,RR101,1,,7980,14400,22380,133000,240000,373000,2017
0C8FAC57-730B-E811-80C3-3863BB430E3F,11234,40.633363,-73.927546,5.7,"SINGLE FAM RES,ATTAC",A5,RR101,1,,7980,14400,22380,133000,240000,373000,2017
7075D757-730B-E811-80C3-3863BB430E3F,11234,40.63193,-73.927393,6,"SFR,PERMANENT LIVING",A2,RR101,1,,6700,7700,14400,134000,154000,288000,2017
6E95B857-730B-E811-80C3-3863BB430E3F,11234,40.631652,-73.927363,6,"SFR,PERMANENT LIVING",A2,RR101,1,,8495,9217,17712,153000,166000,319000,2017
B881C457-730B-E811-80C3-3863BB430E3F,11234,40.631584,-73.927356,6,"SFR,PERMANENT LIVING",A2,RR101,1,,9180,7260,16440,153000,121000,274000,2017
BEDEBF57-730B-E811-80C3-3863BB430E3F,11234,40.631515,-73.927349,6,"SFR,PERMANENT LIVING",A2,RR101,1,,9180,11340,20520,153000,189000,342000,2017
B233DC57-730B-E811-80C3-3863BB430E3F,11234,40.63023,-73.927272,5.8,"SFR,PERMANENT LIVING",A2,RR101,1,,8674,16944,25618,172000,336000,508000,2017
2AE4AE57-730B-E811-80C3-3863BB430E3F,11234,40.625025,-73.927231,4.6,"SFR,PERMANENT LIVING",A2,RR101,1,,13340,17182,30522,257000,331000,588000,2017
A104AF57-730B-E811-80C3-3863BB430E3F,11234,40.624739,-73.9272,4.6,"SINGLE FAM RES,ATTAC",A5,RR101,1,,8872,17502,26374,183000,361000,544000,2017
CA4CC457-730B-E811-80C3-3863BB430E3F,11234,40.625553,-73.926852,4.8,"SFR,PERMANENT LIVING",A2,RR101,1,,9094,16949,26043,176000,328000,504000,2017
F237D057-730B-E811-80C3-3863BB430E3F,11234,40.625558,-73.926769,4.7,"SFR,PERMANENT LIVING",A2,RR101,1,,8056,17822,25878,146000,323000,469000,2017
4B20BD57-730B-E811-80C3-3863BB430E3F,11234,40.625324,-73.926688,4.6,"SFR,PERMANENT LIVING",A2,RR101,1,,7531,16517,24048,145000,318000,463000,2017
C82FD557-730B-E811-80C3-3863BB430E3F,11234,40.628411,-73.926686,5.2,"SFR,PERMANENT LIVING",A2,RR101,1,,9450,16726,26176,187000,331000,518000,2017
A001D557-730B-E811-80C3-3863BB430E3F,11234,40.625253,-73.926681,4.6,"SFR,PERMANENT LIVING",A2,RR101,1,,9991,17047,27038,177000,302000,479000,2017
B570A557-730B-E811-80C3-3863BB430E3F,11234,40.625039,-73.926657,4.6,"SFR,PERMANENT LIVING",A2,RR101,1,,7766,17448,25214,142000,319000,461000,2017
0C88CB57-730B-E811-80C3-3863BB430E3F,11234,40.633603,-73.926633,5.5,"SINGLE FAM RES,ATTAC",A5,RR101,1,,9240,11760,21000,154000,196000,350000,2017
2157B157-730B-E811-80C3-3863BB430E3F,11234,40.624776,-73.926629,4.6,"SFR,PERMANENT LIVING",A2,RR101,1,,6877,16235,23112,133000,314000,447000,2017
234FB157-730B-E811-80C3-3863BB430E3F,11234,40.633543,-73.926627,5.6,"SINGLE FAM RES,ATTAC",A5,RR101,1,,9240,11760,21000,154000,196000,350000,2017
9FD89B57-730B-E811-80C3-3863BB430E3F,11234,40.633426,-73.926614,5.7,"SINGLE FAM RES,ATTAC",A5,RR101,1,,9240,11760,21000,154000,196000,350000,2017
2E11C957-730B-E811-80C3-3863BB430E3F,11234,40.624595,-73.92661,4.7,"SFR,PERMANENT LIVING",A2,RR101,1,,6919,16337,23256,133000,314000,447000,2017
349EBF57-730B-E811-80C3-3863BB430E3F,11234,40.625567,-73.926609,4.7,"SFR,PERMANENT LIVING",A2,RR101,1,,8530,18686,27216,147000,322000,469000,2017
CC2DAA57-730B-E811-80C3-3863BB430E3F,11234,40.624475,-73.926597,4.7,"SFR,PERMANENT LIVING",A2,RR101,1,,6919,16337,23256,133000,314000,447000,2017
5088BF57-730B-E811-80C3-3863BB430E3F,11234,40.611243,-73.926502,3.8,"SFR,PERMANENT LIVING",A2,RR101,1,,15514,26003,41517,284000,476000,760000,2017
40A8D257-730B-E811-80C3-3863BB430E3F,11234,40.625577,-73.926451,4.7,"SFR,PERMANENT LIVING",A2,RR101,1,,8056,17822,25878,146000,323000,469000,2017
68F1CD57-730B-E811-80C3-3863BB430E3F,11234,40.626435,-73.926439,5,"SFR,PERMANENT LIVING",A2,RR101,1,,9496,20363,29859,180000,386000,566000,2017
B412C957-730B-E811-80C3-3863BB430E3F,11234,40.626242,-73.926418,4.9,"SFR,PERMANENT LIVING",A2,RR101,1,,7785,18927,26712,153000,372000,525000,2017
F22CD557-730B-E811-80C3-3863BB430E3F,11234,40.625058,-73.926297,4.6,"SFR,PERMANENT LIVING",A2,RR101,1,,6811,16237,23048,138000,329000,467000,2017
4C6CB857-730B-E811-80C3-3863BB430E3F,11234,40.611056,-73.926294,3.7,"SINGLE FAM RES, DETA",A1,RR101,1,,6775,20191,26966,150000,447000,597000,2017
3454C457-730B-E811-80C3-3863BB430E3F,11234,40.624938,-73.926284,4.6,"SFR,PERMANENT LIVING",A2,RR101,1,,6643,16405,23048,132000,326000,458000,2017
61FEB557-730B-E811-80C3-3863BB430E3F,11234,40.624815,-73.926271,4.6,"SFR,PERMANENT LIVING",A2,RR101,1,,7315,18065,25380,132000,326000,458000,2017
21D0B357-730B-E811-80C3-3863BB430E3F,11234,40.624755,-73.926265,4.6,"SFR,PERMANENT LIVING",A2,RR101,1,,7315,18065,25380,132000,326000,458000,2017
0E6AD757-730B-E811-80C3-3863BB430E3F,11234,40.629196,-73.926166,5.2,"SINGLE FAM RES,ATTAC",A5,RR101,1,,11874,15958,27832,253000,340000,593000,2017
8500B657-730B-E811-80C3-3863BB430E3F,11234,40.626485,-73.925875,4.9,"SFR,PERMANENT LIVING",A2,RR101,1,,10320,19680,30000,172000,328000,500000,2017
D2D7AE57-730B-E811-80C3-3863BB430E3F,11234,40.60833,-73.925722,2.9,"SFR,PERMANENT LIVING",A2,RR101,1,,6289,19666,25955,142000,444000,586000,2017
A09DBF57-730B-E811-80C3-3863BB430E3F,11234,40.6248,-73.925696,4.7,"SFR,PERMANENT LIVING",A2,RR101,1,,7523,16885,24408,131000,294000,425000,2017
B2DAAE57-730B-E811-80C3-3863BB430E3F,11234,40.608983,-73.92569,3,"SFR,PERMANENT LIVING",A2,RR101,1,,16700,20951,37651,279000,350000,629000,2017
88F2CD57-730B-E811-80C3-3863BB430E3F,11234,40.609381,-73.925657,3,"SFR,PERMANENT LIVING",A2,RR101,1,,5284,13255,18539,120000,301000,421000,2017
906BC457-730B-E811-80C3-3863BB430E3F,11234,40.609337,-73.925608,3,"SINGLE FAM RES,ATTAC",A5,RR101,1,,5245,13158,18403,120000,301000,421000,2017
CAE9CD57-730B-E811-80C3-3863BB430E3F,11234,40.610526,-73.925556,3.3,LARGE SUBURBAN RESID,A3,RR101,1,,16214,24449,40663,315000,475000,790000,2017
445D9957-730B-E811-80C3-3863BB430E3F,11234,40.609276,-73.925542,3,"SFR,PERMANENT LIVING",A2,RR101,1,,10822,11032,21854,257000,262000,519000,2017
CCB4BF57-730B-E811-80C3-3863BB430E3F,11234,40.636202,-73.925539,4.5,"SINGLE FAM RES,ATTAC",A5,RR101,1,,10203,14845,25048,178000,259000,437000,2017
59B1B357-730B-E811-80C3-3863BB430E3F,11234,40.636144,-73.925533,4.5,"SINGLE FAM RES,ATTAC",A5,RR101,1,,6477,16347,22824,126000,318000,444000,2017
0E4DAA57-730B-E811-80C3-3863BB430E3F,11234,40.635948,-73.925511,4.6,"SINGLE FAM RES,ATTAC",A5,RR101,1,,10645,15233,25878,181000,259000,440000,2017
67B6B357-730B-E811-80C3-3863BB430E3F,11234,40.635889,-73.925504,4.6,"SINGLE FAM RES,ATTAC",A5,RR101,1,,10478,15400,25878,181000,266000,447000,2017
C296B857-730B-E811-80C3-3863BB430E3F,11234,40.63583,-73.925498,4.6,"SINGLE FAM RES,ATTAC",A5,RR101,1,,10421,15457,25878,180000,267000,447000,2017
103CD557-730B-E811-80C3-3863BB430E3F,11234,40.609897,-73.92548,3.2,"SFR,PERMANENT LIVING",A2,RR101,1,,14286,20274,34560,303000,430000,733000,2017
272EBD57-730B-E811-80C3-3863BB430E3F,11234,40.608737,-73.925433,2.8,"SINGLE FAM RES,ATTAC",A5,RR101,1,,6403,20158,26561,142000,447000,589000,2017
8745B157-730B-E811-80C3-3863BB430E3F,11234,40.63035,-73.925408,5.2,"SFR,PERMANENT LIVING",A2,RR101,1,,18998,14179,33177,343000,256000,599000,2017
591BB657-730B-E811-80C3-3863BB430E3F,11234,40.625433,-73.925396,4.5,"SFR,PERMANENT LIVING",A2,RR101,1,,7435,16757,24192,130000,293000,423000,2017
D5E49B57-730B-E811-80C3-3863BB430E3F,11234,40.625374,-73.92539,4.5,"SFR,PERMANENT LIVING",A2,RR101,1,,7413,16707,24120,130000,293000,423000,2017
47A5B357-730B-E811-80C3-3863BB430E3F,11234,40.608695,-73.925387,2.8,"SINGLE FAM RES,ATTAC",A5,RR101,1,,6403,20158,26561,142000,447000,589000,2017
50D5D957-730B-E811-80C3-3863BB430E3F,11234,40.625317,-73.925383,4.5,"SFR,PERMANENT LIVING",A2,RR101,1,,9002,16157,25159,151000,271000,422000,2017
ECEABF57-730B-E811-80C3-3863BB430E3F,11234,40.625259,-73.925377,4.6,"SFR,PERMANENT LIVING",A2,RR101,1,,7364,16540,23904,130000,292000,422000,2017
E633DC57-730B-E811-80C3-3863BB430E3F,11234,40.630166,-73.925265,5.1,"SINGLE FAM RES,ATTAC",A5,RR101,1,,17640,7980,25620,294000,133000,427000,2017
E56D9957-730B-E811-80C3-3863BB430E3F,11234,40.630057,-73.925253,5,"SFR,PERMANENT LIVING",A2,RR101,1,,13644,12457,26101,230000,210000,440000,2017
C406A357-730B-E811-80C3-3863BB430E3F,11234,40.626159,-73.924965,4.7,"SFR,PERMANENT LIVING",A2,RR101,1,,9697,23057,32754,188000,447000,635000,2017
9D5BBD57-730B-E811-80C3-3863BB430E3F,11234,40.610154,-73.924551,3,"SFR,PERMANENT LIVING",A2,RR101,1,,8464,10344,18808,180000,220000,400000,2017
4C80CB57-730B-E811-80C3-3863BB430E3F,11234,40.61738,-73.924539,4.3,"SFR,PERMANENT LIVING",A2,RR101,1,,15480,14820,30300,258000,247000,505000,2017
4C18C957-730B-E811-80C3-3863BB430E3F,11234,40.609944,-73.924317,2.9,"SFR,PERMANENT LIVING",A2,RR101,1,,6426,11168,17594,168000,292000,460000,2017
F06BD757-730B-E811-80C3-3863BB430E3F,11234,40.624713,-73.924313,4.6,"SFR,PERMANENT LIVING",A2,RR101,1,,22827,16668,39495,404000,295000,699000,2017
343DD557-730B-E811-80C3-3863BB430E3F,11234,40.609881,-73.924247,2.9,"SFR,PERMANENT LIVING",A2,RR101,1,,6398,11196,17594,168000,294000,462000,2017
7802C257-730B-E811-80C3-3863BB430E3F,11234,40.619675,-73.924142,4.8,"SFR,PERMANENT LIVING",A2,RR101,1,,13740,15120,28860,229000,252000,481000,2017
90D8CB57-730B-E811-80C3-3863BB430E3F,11234,40.619675,-73.924142,4.8,"SFR,PERMANENT LIVING",A2,RR101,1,,13740,15120,28860,229000,252000,481000,2017
1A57C457-730B-E811-80C3-3863BB430E3F,11234,40.626644,-73.923941,4.7,"SFR,PERMANENT LIVING",A2,RR101,1,,16404,21297,37701,295000,383000,678000,2017
3A91BF57-730B-E811-80C3-3863BB430E3F,11234,40.633648,-73.923744,4.3,"SFR,PERMANENT LIVING",A2,RR101,1,,9106,8808,17914,183000,177000,360000,2017
0CB6D257-730B-E811-80C3-3863BB430E3F,11234,40.614818,-73.923689,2.9,"SFR,PERMANENT LIVING",A2,RR101,1,,4908,9249,14157,130000,245000,375000,2017
BC06D557-730B-E811-80C3-3863BB430E3F,11234,40.614822,-73.923618,2.9,"SFR,PERMANENT LIVING",A2,RR101,1,,4884,9205,14089,130000,245000,375000,2017
2657A557-730B-E811-80C3-3863BB430E3F,11234,40.631788,-73.923552,4.6,"SINGLE FAM RES,ATTAC",A5,RR101,1,,8220,11220,19440,137000,187000,324000,2017
00C2CB57-730B-E811-80C3-3863BB430E3F,11234,40.617346,-73.923523,4.1,"SFR,PERMANENT LIVING",A2,RR101,1,,8075,17744,25819,157000,345000,502000,2017
81B8B357-730B-E811-80C3-3863BB430E3F,11234,40.614831,-73.923475,3,"SFR,PERMANENT LIVING",A2,RR101,1,,4726,9228,13954,127000,248000,375000,2017
4A5FB857-730B-E811-80C3-3863BB430E3F,11234,40.625217,-73.923427,4.4,"SFR,PERMANENT LIVING",A2,RR101,1,,15420,10440,25860,257000,174000,431000,2017
013FB157-730B-E811-80C3-3863BB430E3F,11234,40.624887,-73.923392,4.4,"SFR,PERMANENT LIVING",A2,RR101,1,,15420,10440,25860,257000,174000,431000,2017
DAC7A057-730B-E811-80C3-3863BB430E3F,11234,40.61484,-73.923334,3,"SFR,PERMANENT LIVING",A2,RR101,1,,4703,9184,13887,127000,248000,375000,2017
D494D257-730B-E811-80C3-3863BB430E3F,11234,40.631948,-73.923205,4.5,"SINGLE FAM RES,ATTAC",A5,RR101,1,,15060,5880,20940,251000,98000,349000,2017
E12BBD57-730B-E811-80C3-3863BB430E3F,11234,40.63049,-73.923196,4.4,"SINGLE FAM RES,ATTAC",A5,RR101,1,,6475,11439,17914,120000,212000,332000,2017
4CAECB57-730B-E811-80C3-3863BB430E3F,11234,40.617203,-73.922933,3.9,"SFR,PERMANENT LIVING",A2,RR101,1,,13273,22946,36219,236000,408000,644000,2017
7D67BD57-730B-E811-80C3-3863BB430E3F,11234,40.625498,-73.922875,4.4,"SFR,PERMANENT LIVING",A2,RR101,1,,13440,15480,28920,224000,258000,482000,2017
9E98BF57-730B-E811-80C3-3863BB430E3F,11234,40.625388,-73.922863,4.4,"SFR,PERMANENT LIVING",A2,RR101,1,,13620,15300,28920,227000,255000,482000,2017
D7AFB357-730B-E811-80C3-3863BB430E3F,11234,40.62517,-73.92284,4.4,"SFR,PERMANENT LIVING",A2,RR101,1,,13620,15300,28920,227000,255000,482000,2017
EC65C457-730B-E811-80C3-3863BB430E3F,11234,40.624513,-73.92277,4.4,"SFR,PERMANENT LIVING",A2,RR101,1,,14340,12540,26880,239000,209000,448000,2017
F9DE9B57-730B-E811-80C3-3863BB430E3F,11234,40.624404,-73.922759,4.4,"SFR,PERMANENT LIVING",A2,RR101,1,,13440,15480,28920,224000,258000,482000,2017
D618C257-730B-E811-80C3-3863BB430E3F,11234,40.624186,-73.922735,4.4,"SFR,PERMANENT LIVING",A2,RR101,1,,14640,14280,28920,244000,238000,482000,2017
8EEBC157-730B-E811-80C3-3863BB430E3F,11234,40.617608,-73.922609,4.1,"SFR,PERMANENT LIVING",A2,RR101,1,,11819,18855,30674,210000,335000,545000,2017
A416C957-730B-E811-80C3-3863BB430E3F,11234,40.631362,-73.921549,4.3,"SINGLE FAM RES,ATTAC",A5,RR101,1,,7320,10680,18000,122000,178000,300000,2017
463CD557-730B-E811-80C3-3863BB430E3F,11234,40.631307,-73.921543,4.3,"SINGLE FAM RES,ATTAC",A5,RR101,1,,7020,10440,17460,117000,174000,291000,2017
91C39B57-730B-E811-80C3-3863BB430E3F,11234,40.631251,-73.921537,4.3,"SINGLE FAM RES,ATTAC",A5,RR101,1,,8280,9840,18120,138000,164000,302000,2017
CE8AA557-730B-E811-80C3-3863BB430E3F,11234,40.623691,-73.921314,4.3,"SFR,PERMANENT LIVING",A2,RR101,1,,13291,17618,30909,258000,342000,600000,2017
3AAEA057-730B-E811-80C3-3863BB430E3F,11234,40.623582,-73.921302,4.4,"SFR,PERMANENT LIVING",A2,RR101,1,,13193,17591,30784,258000,344000,602000,2017
8C45AA57-730B-E811-80C3-3863BB430E3F,11234,40.631439,-73.921196,4.3,"SINGLE FAM RES,ATTAC",A5,RR101,1,,7680,11400,19080,128000,190000,318000,2017
D29EA057-730B-E811-80C3-3863BB430E3F,11234,40.631385,-73.92119,4.3,"SINGLE FAM RES,ATTAC",A5,RR101,1,,7620,11460,19080,127000,191000,318000,2017
5643D057-730B-E811-80C3-3863BB430E3F,11234,40.63133,-73.921184,4.3,"SINGLE FAM RES,ATTAC",A5,RR101,1,,7620,11460,19080,127000,191000,318000,2017
DF0FB657-730B-E811-80C3-3863BB430E3F,11236,40.648963,-73.921177,7.2,"SINGLE FAM RES,ATTAC",A5,RR101,1,,13560,9300,22860,226000,155000,381000,2017
7CA8BF57-730B-E811-80C3-3863BB430E3F,11234,40.623643,-73.920874,4.3,"SFR,PERMANENT LIVING",A2,RR101,1,,5319,14409,19728,110000,298000,408000,2017
FC15C257-730B-E811-80C3-3863BB430E3F,11234,40.623648,-73.920803,4.3,"SFR,PERMANENT LIVING",A2,RR101,1,,4933,14147,19080,106000,304000,410000,2017
A671C457-730B-E811-80C3-3863BB430E3F,11234,40.615478,-73.920801,2.8,"SFR,PERMANENT LIVING",A2,RR101,1,,13072,14029,27101,246000,264000,510000,2017
14FDC157-730B-E811-80C3-3863BB430E3F,11234,40.617471,-73.920647,3.8,"SFR,PERMANENT LIVING",A2,RR101,1,,6702,14794,21496,164000,362000,526000,2017
CEAABF57-730B-E811-80C3-3863BB430E3F,11234,40.622762,-73.920639,4.3,"SFR,PERMANENT LIVING",A2,RR101,1,,11639,13442,25081,213000,246000,459000,2017
BA78B857-730B-E811-80C3-3863BB430E3F,11234,40.622491,-73.92061,4.2,"SFR,PERMANENT LIVING",A2,RR101,1,,14874,17887,32761,311000,374000,685000,2017
0C17AA57-730B-E811-80C3-3863BB430E3F,11234,40.620485,-73.920393,4.4,"SFR,PERMANENT LIVING",A2,RR101,1,,7201,12503,19704,182000,316000,498000,2017
B1DDB357-730B-E811-80C3-3863BB430E3F,11236,40.650101,-73.920392,7.8,"SINGLE FAM RES,ATTAC",A5,RR101,1,,20952,8078,29030,402000,155000,557000,2017
B0D6CD57-730B-E811-80C3-3863BB430E3F,11236,40.646607,-73.92006,5.8,"SINGLE FAM RES,ATTAC",A5,RR101,1,,10650,11329,21979,235000,250000,485000,2017
3E2F9E57-730B-E811-80C3-3863BB430E3F,11236,40.648593,-73.919966,7,"SINGLE FAM RES,ATTAC",A5,RR101,1,,11362,11363,22725,221000,221000,442000,2017
724FC457-730B-E811-80C3-3863BB430E3F,11236,40.648546,-73.919914,7,"SINGLE FAM RES,ATTAC",A5,RR101,1,,12729,9665,22394,216000,164000,380000,2017
2E35DC57-730B-E811-80C3-3863BB430E3F,11236,40.650507,-73.919893,8.3,"SINGLE FAM RES,ATTAC",A5,RR101,1,,14112,8784,22896,241000,150000,391000,2017
B2D1CD57-730B-E811-80C3-3863BB430E3F,11236,40.646764,-73.919816,5.8,"SINGLE FAM RES,ATTAC",A5,RR101,1,,12774,10274,23048,235000,189000,424000,2017
6270AC57-730B-E811-80C3-3863BB430E3F,11236,40.649097,-73.919778,7.4,"SINGLE FAM RES,ATTAC",A5,RR101,1,,13440,7740,21180,224000,129000,353000,2017
4A15C957-730B-E811-80C3-3863BB430E3F,11236,40.649483,-73.919729,7.5,"SFR,PERMANENT LIVING",A2,RR101,1,,13500,7800,21300,225000,130000,355000,2017
569CB857-730B-E811-80C3-3863BB430E3F,11236,40.649438,-73.919678,7.5,"SFR,PERMANENT LIVING",A2,RR101,1,,13500,7800,21300,225000,130000,355000,2017
24F9D457-730B-E811-80C3-3863BB430E3F,11236,40.648959,-73.919624,7.4,"SINGLE FAM RES,ATTAC",A5,RR101,1,,13440,7740,21180,224000,129000,353000,2017
5C8EBF57-730B-E811-80C3-3863BB430E3F,11236,40.648272,-73.919607,6.8,"SINGLE FAM RES,ATTAC",A5,RR101,1,,12729,9665,22394,216000,164000,380000,2017
D66DB857-730B-E811-80C3-3863BB430E3F,11234,40.616229,-73.919571,3.4,"SINGLE FAM RES,ATTAC",A5,RR101,1,,9897,13630,23527,167000,230000,397000,2017
9E8EBF57-730B-E811-80C3-3863BB430E3F,11234,40.620878,-73.91951,4.3,"SFR,PERMANENT LIVING",A2,RR101,1,,6227,13862,20089,146000,325000,471000,2017
3C17D557-730B-E811-80C3-3863BB430E3F,11234,40.615626,-73.919507,3.4,"SINGLE FAM RES,ATTAC",A5,RR101,1,,9982,13748,23730,167000,230000,397000,2017
8762A557-730B-E811-80C3-3863BB430E3F,11236,40.647996,-73.919444,6.6,"SINGLE FAM RES,ATTAC",A5,RR101,1,,11361,12517,23878,236000,260000,496000,2017
E250D057-730B-E811-80C3-3863BB430E3F,11234,40.623555,-73.919415,4.3,"SFR,PERMANENT LIVING",A2,RR101,1,,13476,16161,29637,256000,307000,563000,2017
1911AF57-730B-E811-80C3-3863BB430E3F,11236,40.648717,-73.919354,7.4,"SINGLE FAM RES,ATTAC",A5,RR101,1,,13683,9849,23532,257000,185000,442000,2017
DC8DA557-730B-E811-80C3-3863BB430E3F,11234,40.623744,-73.919324,4.3,"SFR,PERMANENT LIVING",A2,RR101,1,,26640,14640,41280,444000,244000,688000,2017
8C8EB857-730B-E811-80C3-3863BB430E3F,11236,40.647502,-73.919209,6.4,"SINGLE FAM RES,ATTAC",A5,RR101,1,,13606,14187,27793,234000,244000,478000,2017
267DAC57-730B-E811-80C3-3863BB430E3F,11234,40.618221,-73.919154,3.8,"SFR,PERMANENT LIVING",A2,RR101,1,,11797,20966,32763,238000,423000,661000,2017
4995B357-730B-E811-80C3-3863BB430E3F,11236,40.647544,-73.919145,6.5,"SINGLE FAM RES,ATTAC",A5,RR101,1,,12122,12618,24740,220000,229000,449000,2017
9860D757-730B-E811-80C3-3863BB430E3F,11236,40.647562,-73.919057,6.6,"SINGLE FAM RES,ATTAC",A5,RR101,1,,14229,12558,26787,264000,233000,497000,2017
0DF7B557-730B-E811-80C3-3863BB430E3F,11236,40.648264,-73.919031,7.2,"SINGLE FAM RES,ATTAC",A5,RR101,1,,11444,13936,25380,248000,302000,550000,2017
0BEA9B57-730B-E811-80C3-3863BB430E3F,11234,40.615674,-73.918997,3.3,"SINGLE FAM RES,ATTAC",A5,RR101,1,,13463,11818,25281,262000,230000,492000,2017
261AAA57-730B-E811-80C3-3863BB430E3F,11234,40.616043,-73.91898,3.3,"SINGLE FAM RES,ATTAC",A5,RR101,1,,5396,9704,15100,139000,250000,389000,2017
FEC4A057-730B-E811-80C3-3863BB430E3F,11234,40.615825,-73.918957,3.3,"SINGLE FAM RES,ATTAC",A5,RR101,1,,6245,10001,16246,148000,237000,385000,2017
9888A557-730B-E811-80C3-3863BB430E3F,11236,40.64762,-73.918918,6.8,"SINGLE FAM RES,ATTAC",A5,RR101,1,,14229,12558,26787,264000,233000,497000,2017
3610C257-730B-E811-80C3-3863BB430E3F,11236,40.649758,-73.918809,8.1,"SFR,PERMANENT LIVING",A2,RR101,1,,14277,9255,23532,253000,164000,417000,2017
03C8B357-730B-E811-80C3-3863BB430E3F,11236,40.648421,-73.918791,7.4,"SINGLE FAM RES,ATTAC",A5,RR101,1,,12277,11609,23886,239000,226000,465000,2017
180DAA57-730B-E811-80C3-3863BB430E3F,11236,40.64846,-73.91873,7.4,"SINGLE FAM RES,ATTAC",A5,RR101,1,,12481,11405,23886,232000,212000,444000,2017
C734BD57-730B-E811-80C3-3863BB430E3F,11236,40.649653,-73.918692,8.1,"SFR,PERMANENT LIVING",A2,RR101,1,,14302,9102,23404,253000,161000,414000,2017
10EDCD57-730B-E811-80C3-3863BB430E3F,11234,40.617286,-73.918673,3.4,"SINGLE FAM RES,ATTAC",A5,RR101,1,,5872,17049,22921,135000,392000,527000,2017
CCDECB57-730B-E811-80C3-3863BB430E3F,11236,40.65,-73.918326,8.4,"SINGLE FAM RES,ATTAC",A5,RR101,1,,12420,10500,22920,207000,175000,382000,2017
A0C4D957-730B-E811-80C3-3863BB430E3F,11236,40.648126,-73.918251,7.5,"SINGLE FAM RES,ATTAC",A5,RR101,1,,13200,8580,21780,220000,143000,363000,2017
C11BB657-730B-E811-80C3-3863BB430E3F,11236,40.652839,-73.917618,8.8,"SINGLE FAM RES,ATTAC",A5,RR101,1,,14400,9540,23940,240000,159000,399000,2017
030CAF57-730B-E811-80C3-3863BB430E3F,11236,40.652043,-73.917529,8.9,"SINGLE FAM RES,ATTAC",A5,RR101,1,,14340,8340,22680,239000,139000,378000,2017
F3BBBA57-730B-E811-80C3-3863BB430E3F,11236,40.652742,-73.91751,8.8,"SINGLE FAM RES,ATTAC",A5,RR101,1,,13860,8940,22800,231000,149000,380000,2017
9C09D557-730B-E811-80C3-3863BB430E3F,11236,40.652085,-73.917463,8.9,"SINGLE FAM RES,ATTAC",A5,RR101,1,,14220,9120,23340,237000,152000,389000,2017
B01BD557-730B-E811-80C3-3863BB430E3F,11236,40.652645,-73.917402,8.8,"SINGLE FAM RES,ATTAC",A5,RR101,1,,13895,10489,24384,257000,194000,451000,2017
A438DC57-730B-E811-80C3-3863BB430E3F,11236,40.647233,-73.917222,7.5,"SINGLE FAM RES,ATTAC",A5,RR101,1,,15226,7554,22780,383000,190000,573000,2017
334EBD57-730B-E811-80C3-3863BB430E3F,11236,40.651983,-73.916614,8.7,"SINGLE FAM RES,ATTAC",A5,RR101,1,,14940,8400,23340,249000,140000,389000,2017
0F71A557-730B-E811-80C3-3863BB430E3F,11236,40.651243,-73.916584,8.6,"SINGLE FAM RES,ATTAC",A5,RR101,1,,13500,6600,20100,225000,110000,335000,2017
59C2B357-730B-E811-80C3-3863BB430E3F,11236,40.651196,-73.916532,8.6,"SFR,PERMANENT LIVING",A2,RR101,1,,13140,6960,20100,219000,116000,335000,2017
F4C1CB57-730B-E811-80C3-3863BB430E3F,11236,40.651833,-73.916491,8.7,"SINGLE FAM RES,ATTAC",A5,RR101,1,,16140,6720,22860,269000,112000,381000,2017
C4ABCB57-730B-E811-80C3-3863BB430E3F,11236,40.651778,-73.91643,8.7,"SINGLE FAM RES,ATTAC",A5,RR101,1,,12900,6420,19320,215000,107000,322000,2017
1F0DB657-730B-E811-80C3-3863BB430E3F,11236,40.64995,-73.916416,8.2,"SFR,PERMANENT LIVING",A2,RR101,1,,14280,7080,21360,238000,118000,356000,2017
182BD557-730B-E811-80C3-3863BB430E3F,11236,40.651057,-73.916377,8.5,"SINGLE FAM RES,ATTAC",A5,RR101,1,,13560,5700,19260,226000,95000,321000,2017
5AE5BF57-730B-E811-80C3-3863BB430E3F,11236,40.651731,-73.916377,8.6,"SINGLE FAM RES,ATTAC",A5,RR101,1,,12900,6420,19320,215000,107000,322000,2017
5553B157-730B-E811-80C3-3863BB430E3F,11236,40.650965,-73.916275,8.4,"SINGLE FAM RES,ATTAC",A5,RR101,1,,11460,8340,19800,191000,139000,330000,2017
DF02B657-730B-E811-80C3-3863BB430E3F,11236,40.650526,-73.916268,8.3,"SINGLE FAM RES,ATTAC",A5,RR101,1,,13320,6540,19860,222000,109000,331000,2017
F282BF57-730B-E811-80C3-3863BB430E3F,11236,40.641395,-73.916211,5.8,"SFR,PERMANENT LIVING",A2,RR101,1,,17400,5220,22620,290000,87000,377000,2017
80A6A057-730B-E811-80C3-3863BB430E3F,11236,40.650872,-73.916171,8.3,"SINGLE FAM RES,ATTAC",A5,RR101,1,,13260,6540,19800,221000,109000,330000,2017
747EA557-730B-E811-80C3-3863BB430E3F,11236,40.651527,-73.91615,8.5,"SINGLE FAM RES,ATTAC",A5,RR101,1,,12960,6480,19440,216000,108000,324000,2017
9695BF57-730B-E811-80C3-3863BB430E3F,11236,40.650826,-73.91612,8.3,"SINGLE FAM RES,ATTAC",A5,RR101,1,,13260,6540,19800,221000,109000,330000,2017
7E8BAC57-730B-E811-80C3-3863BB430E3F,11236,40.651481,-73.916098,8.5,"SINGLE FAM RES,ATTAC",A5,RR101,1,,12720,6300,19020,212000,105000,317000,2017
269EBF57-730B-E811-80C3-3863BB430E3F,11236,40.651435,-73.916047,8.4,"SINGLE FAM RES,ATTAC",A5,RR101,1,,12720,6300,19020,212000,105000,317000,2017
B94BB157-730B-E811-80C3-3863BB430E3F,11236,40.651389,-73.915995,8.4,"SINGLE FAM RES,ATTAC",A5,RR101,1,,12720,6300,19020,212000,105000,317000,2017
0B77A557-730B-E811-80C3-3863BB430E3F,11236,40.651758,-73.915934,8.5,"SINGLE FAM RES,ATTAC",A5,RR101,1,,13200,7440,20640,220000,124000,344000,2017
67CA9B57-730B-E811-80C3-3863BB430E3F,11236,40.651758,-73.915934,8.5,"SINGLE FAM RES,ATTAC",A5,RR101,1,,13200,7440,20640,220000,124000,344000,2017
EC88A057-730B-E811-80C3-3863BB430E3F,11236,40.651666,-73.915831,8.4,"SINGLE FAM RES,ATTAC",A5,RR101,1,,13200,7440,20640,220000,124000,344000,2017
30E2CD57-730B-E811-80C3-3863BB430E3F,11236,40.652312,-73.915821,8.4,"SINGLE FAM RES,ATTAC",A5,RR101,1,,13080,8940,22020,218000,149000,367000,2017
FE1BC957-730B-E811-80C3-3863BB430E3F,11236,40.652312,-73.915821,8.4,"SINGLE FAM RES,ATTAC",A5,RR101,1,,13080,8940,22020,218000,149000,367000,2017
90259E57-730B-E811-80C3-3863BB430E3F,11236,40.651206,-73.91579,8.3,"SINGLE FAM RES,ATTAC",A5,RR101,1,,12720,6300,19020,212000,105000,317000,2017
DE87AC57-730B-E811-80C3-3863BB430E3F,11236,40.652591,-73.915665,8.4,"SINGLE FAM RES,ATTAC",A5,RR101,1,,14520,8880,23400,242000,148000,390000,2017
44D6D957-730B-E811-80C3-3863BB430E3F,11236,40.651507,-73.915653,8.3,"SINGLE FAM RES,ATTAC",A5,RR101,1,,16320,8940,25260,272000,149000,421000,2017
14D2CB57-730B-E811-80C3-3863BB430E3F,11236,40.651069,-73.915636,8.2,"SINGLE FAM RES,ATTAC",A5,RR101,1,,12720,6300,19020,212000,105000,317000,2017
2D9CB357-730B-E811-80C3-3863BB430E3F,11236,40.651451,-73.915591,8.3,"SINGLE FAM RES,ATTAC",A5,RR101,1,,13380,7020,20400,223000,117000,340000,2017
60649957-730B-E811-80C3-3863BB430E3F,11236,40.651022,-73.915584,8.2,"SINGLE FAM RES,ATTAC",A5,RR101,1,,12720,6300,19020,212000,105000,317000,2017
262FC957-730B-E811-80C3-3863BB430E3F,11236,40.649847,-73.915571,7.8,"SINGLE FAM RES,ATTAC",A5,RR101,1,,13860,10680,24540,231000,178000,409000,2017
7AE5BF57-730B-E811-80C3-3863BB430E3F,11236,40.651407,-73.915541,8.2,"SINGLE FAM RES,ATTAC",A5,RR101,1,,13380,7020,20400,223000,117000,340000,2017
5D09AF57-730B-E811-80C3-3863BB430E3F,11236,40.650976,-73.915533,8.1,"SINGLE FAM RES,ATTAC",A5,RR101,1,,12720,6300,19020,212000,105000,317000,2017
ED01AF57-730B-E811-80C3-3863BB430E3F,11236,40.650931,-73.915482,8.1,"SINGLE FAM RES,ATTAC",A5,RR101,1,,12720,6300,19020,212000,105000,317000,2017
10CECB57-730B-E811-80C3-3863BB430E3F,11236,40.650883,-73.915429,8.1,"SINGLE FAM RES,ATTAC",A5,RR101,1,,13440,7320,20760,224000,122000,346000,2017
D887CB57-730B-E811-80C3-3863BB430E3F,11236,40.65127,-73.915388,8.1,"SINGLE FAM RES,ATTAC",A5,RR101,1,,13440,7020,20460,224000,117000,341000,2017
363D9E57-730B-E811-80C3-3863BB430E3F,11236,40.652283,-73.915294,8.3,"SINGLE FAM RES,ATTAC",A5,RR101,1,,16320,12120,28440,272000,202000,474000,2017
B6219E57-730B-E811-80C3-3863BB430E3F,11236,40.652752,-73.915064,8.3,"SINGLE FAM RES,ATTAC",A5,RR101,1,,15816,9878,25694,277000,173000,450000,2017
32F8D457-730B-E811-80C3-3863BB430E3F,11236,40.652696,-73.915003,8.3,"SINGLE FAM RES,ATTAC",A5,RR101,1,,13166,9412,22578,228000,163000,391000,2017
F548BD57-730B-E811-80C3-3863BB430E3F,11236,40.650875,-73.914998,7.8,"SFR,PERMANENT LIVING",A2,RR101,1,,14220,7560,21780,237000,126000,363000,2017
749CCB57-730B-E811-80C3-3863BB430E3F,11234,40.617378,-73.914974,2.9,"SFR,PERMANENT LIVING",A2,RR101,1,,5255,16958,22213,119000,384000,503000,2017
D0D7D957-730B-E811-80C3-3863BB430E3F,11234,40.620265,-73.914937,2.7,"SFR,PERMANENT LIVING",A2,RR101,1,,10094,19164,29258,217000,412000,629000,2017
FEE4C157-730B-E811-80C3-3863BB430E3F,11234,40.604714,-73.914605,0,"SFR,PERMANENT LIVING",A2,RR101,1,,14221,30610,44831,282000,607000,889000,2017
0A45AA57-730B-E811-80C3-3863BB430E3F,11234,40.617626,-73.91459,3,"SFR,PERMANENT LIVING",A2,RR101,1,,4382,17831,22213,116000,472000,588000,2017
243CD057-730B-E811-80C3-3863BB430E3F,11234,40.619422,-73.914462,2.8,"SFR,PERMANENT LIVING",A2,RR101,1,,7728,16811,24539,171000,372000,543000,2017
588DBF57-730B-E811-80C3-3863BB430E3F,11236,40.653588,-73.914145,8.2,"SINGLE FAM RES,ATTAC",A5,RR101,1,,12641,10827,23468,230000,197000,427000,2017
68DBBF57-730B-E811-80C3-3863BB430E3F,11234,40.60472,-73.913752,0.2,"SFR,PERMANENT LIVING",A2,RR101,1,,14196,40410,54606,300000,854000,1154000,2017
A024C257-730B-E811-80C3-3863BB430E3F,11234,40.604863,-73.91353,0.4,"SFR,PERMANENT LIVING",A2,RR101,1,,14196,40410,54606,300000,854000,1154000,2017
924AA557-730B-E811-80C3-3863BB430E3F,11236,40.638933,-73.913474,2,"SFR,PERMANENT LIVING",A2,RR101,1,,12745,5675,18420,274000,122000,396000,2017
7E25D557-730B-E811-80C3-3863BB430E3F,11234,40.604934,-73.91342,0.4,"SFR,PERMANENT LIVING",A2,RR101,1,,14196,40410,54606,300000,854000,1154000,2017
727AA557-730B-E811-80C3-3863BB430E3F,11236,40.639317,-73.91342,4.3,"SFR,PERMANENT LIVING",A2,RR101,1,,8423,6982,15405,187000,155000,342000,2017
3C15C257-730B-E811-80C3-3863BB430E3F,11236,40.652401,-73.913375,7.9,"SINGLE FAM RES,ATTAC",A5,RR101,1,,14249,11318,25567,243000,193000,436000,2017
F93EBD57-730B-E811-80C3-3863BB430E3F,11234,40.615086,-73.913081,2.9,"SFR,PERMANENT LIVING",A2,RR101,1,,11943,23887,35830,296000,592000,888000,2017
4677B857-730B-E811-80C3-3863BB430E3F,11234,40.614984,-73.912968,2.9,"SFR,PERMANENT LIVING",A2,RR101,1,,11943,23887,35830,296000,592000,888000,2017
8AC0BF57-730B-E811-80C3-3863BB430E3F,11234,40.604634,-73.912894,0.3,"SFR,PERMANENT LIVING",A2,RR101,1,,19990,32861,52851,337000,554000,891000,2017
7D12C255-730B-E811-80C3-3863BB430E3F,11234,40.605288,-73.912872,0.7,"SFR,PERMANENT LIVING",A2,RR101,1,,9541,33806,43347,254000,900000,1154000,2017
5244C457-730B-E811-80C3-3863BB430E3F,11236,40.652303,-73.912773,7.9,"SINGLE FAM RES,ATTAC",A5,RR101,1,,13623,11626,25249,232000,198000,430000,2017
7286B857-730B-E811-80C3-3863BB430E3F,11234,40.604366,-73.912744,0.2,"SFR,PERMANENT LIVING",A2,RR101,1,,20246,32478,52724,341000,547000,888000,2017
B446AA57-730B-E811-80C3-3863BB430E3F,11234,40.614323,-73.912702,2.9,"SFR,PERMANENT LIVING",A2,RR101,1,,13455,29077,42532,298000,644000,942000,2017
4880A057-730B-E811-80C3-3863BB430E3F,11234,40.604778,-73.912671,0.5,"SFR,PERMANENT LIVING",A2,RR101,1,,19752,33099,52851,333000,558000,891000,2017
D9F59B57-730B-E811-80C3-3863BB430E3F,11234,40.61467,-73.912617,2.9,"SINGLE FAM RES, DETA",A1,RR101,1,,19331,21563,40894,329000,367000,696000,2017
893BBD57-730B-E811-80C3-3863BB430E3F,11234,40.614219,-73.912587,2.9,"SFR,PERMANENT LIVING",A2,RR101,1,,15755,21148,36903,298000,400000,698000,2017
2621DC57-730B-E811-80C3-3863BB430E3F,11234,40.60485,-73.91256,0.5,"SFR,PERMANENT LIVING",A2,RR101,1,,19634,33217,52851,331000,560000,891000,2017
2E97D257-730B-E811-80C3-3863BB430E3F,11234,40.604506,-73.912527,0.3,"SFR,PERMANENT LIVING",A2,RR101,1,,20068,32656,52724,338000,550000,888000,2017
D204D557-730B-E811-80C3-3863BB430E3F,11234,40.614564,-73.912498,2.9,"SFR,PERMANENT LIVING",A2,RR101,1,,12540,25081,37621,296000,592000,888000,2017
AE3DD057-730B-E811-80C3-3863BB430E3F,11236,40.643662,-73.912494,5.9,"SFR,PERMANENT LIVING",A2,RR101,1,,6264,4094,10358,153000,100000,253000,2017
8275D757-730B-E811-80C3-3863BB430E3F,11234,40.604922,-73.912449,0.5,"SFR,PERMANENT LIVING",A2,RR101,1,,19714,34409,54123,330000,576000,906000,2017
3897CB57-730B-E811-80C3-3863BB430E3F,11234,40.605579,-73.912422,0.8,"SFR,PERMANENT LIVING",A2,RR101,1,,18159,37872,56031,374000,780000,1154000,2017
061F9E57-730B-E811-80C3-3863BB430E3F,11234,40.604576,-73.912418,0.3,"SFR,PERMANENT LIVING",A2,RR101,1,,20068,32656,52724,338000,550000,888000,2017
BD36BD57-730B-E811-80C3-3863BB430E3F,11234,40.603748,-73.912354,0.1,"SFR,PERMANENT LIVING",A2,RR101,1,,17809,39558,57367,357000,793000,1150000,2017
3318B657-730B-E811-80C3-3863BB430E3F,11236,40.652589,-73.912317,7.8,"SINGLE FAM RES,ATTAC",A5,RR101,1,,13790,12751,26541,252000,233000,485000,2017
8DC49B57-730B-E811-80C3-3863BB430E3F,11234,40.605067,-73.912224,0.6,"SFR,PERMANENT LIVING",A2,RR101,1,,22659,30192,52851,382000,509000,891000,2017
2FCDB357-730B-E811-80C3-3863BB430E3F,11234,40.614176,-73.912183,2.9,"SFR,PERMANENT LIVING",A2,RR101,1,,13490,17546,31036,276000,359000,635000,2017
F9DAB357-730B-E811-80C3-3863BB430E3F,11236,40.652684,-73.912173,7.8,"SINGLE FAM RES,ATTAC",A5,RR101,1,,13738,13300,27038,251000,243000,494000,2017
EE6EB857-730B-E811-80C3-3863BB430E3F,11236,40.63774,-73.912136,4.3,"SFR,PERMANENT LIVING",A2,RR101,1,,12946,8159,21105,284000,179000,463000,2017
FC81A557-730B-E811-80C3-3863BB430E3F,11234,40.604785,-73.912094,0.5,"SFR,PERMANENT LIVING",A2,RR101,1,,21180,27360,48540,353000,456000,809000,2017
49EB9B57-730B-E811-80C3-3863BB430E3F,11234,40.605211,-73.912001,0.7,"SFR,PERMANENT LIVING",A2,RR101,1,,22540,30311,52851,380000,511000,891000,2017
32D0D957-730B-E811-80C3-3863BB430E3F,11234,40.605866,-73.911978,0.9,"SFR,PERMANENT LIVING",A2,RR101,1,,14113,40358,54471,299000,855000,1154000,2017
603CDC57-730B-E811-80C3-3863BB430E3F,11234,40.605866,-73.911978,0.9,"SFR,PERMANENT LIVING",A2,RR101,1,,14113,40358,54471,299000,855000,1154000,2017
C698A057-730B-E811-80C3-3863BB430E3F,11236,40.64135,-73.911963,5.8,"SFR,PERMANENT LIVING",A2,RR101,1,,9926,9182,19108,280000,259000,539000,2017
2E29AA57-730B-E811-80C3-3863BB430E3F,11234,40.610929,-73.911942,2.5,"SFR,PERMANENT LIVING",A2,RR101,1,,16176,30273,46449,350000,655000,1005000,2017
D852C457-730B-E811-80C3-3863BB430E3F,11234,40.60432,-73.911932,0.3,"SFR,PERMANENT LIVING",A2,RR101,1,,21363,33587,54950,367000,577000,944000,2017
EC3E9E57-730B-E811-80C3-3863BB430E3F,11234,40.604927,-73.911874,0.5,"SFR,PERMANENT LIVING",A2,RR101,1,,17854,30617,48471,298000,511000,809000,2017
390BAF57-730B-E811-80C3-3863BB430E3F,11234,40.604387,-73.911827,0.3,"SFR,PERMANENT LIVING",A2,RR101,1,,20620,34076,54696,354000,585000,939000,2017
CADECB57-730B-E811-80C3-3863BB430E3F,11234,40.605352,-73.911783,0.8,"SFR,PERMANENT LIVING",A2,RR101,1,,19159,33692,52851,323000,568000,891000,2017
24A6A057-730B-E811-80C3-3863BB430E3F,11234,40.614465,-73.911751,2.7,"SFR,PERMANENT LIVING",A2,RR101,1,,7679,17736,25415,197000,455000,652000,2017
18AECB57-730B-E811-80C3-3863BB430E3F,11234,40.615663,-73.911737,2.7,"SFR,PERMANENT LIVING",A2,RR101,1,,11737,21229,32966,251000,454000,705000,2017
E356B157-730B-E811-80C3-3863BB430E3F,11234,40.604456,-73.91172,0.4,"SFR,PERMANENT LIVING",A2,RR101,1,,18567,31995,50562,318000,548000,866000,2017
15F8B557-730B-E811-80C3-3863BB430E3F,11234,40.613958,-73.911696,2.8,"SFR,PERMANENT LIVING",A2,RR101,1,,13419,23844,37263,354000,629000,983000,2017
6E23C957-730B-E811-80C3-3863BB430E3F,11234,40.605067,-73.911658,0.6,"SFR,PERMANENT LIVING",A2,RR101,1,,17697,32999,50696,303000,565000,868000,2017
B235D557-730B-E811-80C3-3863BB430E3F,11234,40.603624,-73.911634,0.1,"SFR,PERMANENT LIVING",A2,RR101,1,,16700,37550,54250,338000,760000,1098000,2017
A284CB57-730B-E811-80C3-3863BB430E3F,11234,40.615559,-73.91162,2.7,"SFR,PERMANENT LIVING",A2,RR101,1,,20400,23880,44280,340000,398000,738000,2017
57D6BA57-730B-E811-80C3-3863BB430E3F,11236,40.639648,-73.911612,4.2,"SFR,PERMANENT LIVING",A2,RR101,1,,10920,1740,12660,182000,29000,211000,2017
22C1BF57-730B-E811-80C3-3863BB430E3F,11234,40.605496,-73.911561,0.8,"SFR,PERMANENT LIVING",A2,RR101,1,,19100,33751,52851,322000,569000,891000,2017
60E5A257-730B-E811-80C3-3863BB430E3F,11236,40.639684,-73.911556,4.6,"SFR,PERMANENT LIVING",A2,RR101,1,,7048,2578,9626,175000,64000,239000,2017
3C1AD557-730B-E811-80C3-3863BB430E3F,11234,40.610524,-73.911516,2.3,"SFR,PERMANENT LIVING",A2,RR101,1,,16258,29692,45950,357000,652000,1009000,2017
80D1CB57-730B-E811-80C3-3863BB430E3F,11234,40.604249,-73.911481,0.3,"SFR,PERMANENT LIVING",A2,RR101,1,,21660,33099,54759,373000,570000,943000,2017
6310B657-730B-E811-80C3-3863BB430E3F,11234,40.61584,-73.911465,2.7,"SFR,PERMANENT LIVING",A2,RR101,1,,12904,21882,34786,263000,446000,709000,2017
5C21AA57-730B-E811-80C3-3863BB430E3F,11234,40.606563,-73.911456,0.9,"SINGLE FAM RES, DETA",A1,RR101,1,,19640,34941,54581,353000,628000,981000,2017
B866B857-730B-E811-80C3-3863BB430E3F,11234,40.605568,-73.911449,0.8,"SFR,PERMANENT LIVING",A2,RR101,1,,19500,34020,53520,325000,567000,892000,2017
D497CB57-730B-E811-80C3-3863BB430E3F,11236,40.64548,-73.911448,6.8,"SFR,PERMANENT LIVING",A2,RR101,1,,5642,9265,14907,123000,202000,325000,2017
F944B157-730B-E811-80C3-3863BB430E3F,11234,40.605208,-73.911438,0.6,"SFR,PERMANENT LIVING",A2,RR101,1,,19560,28740,48300,326000,479000,805000,2017
ECE2BF57-730B-E811-80C3-3863BB430E3F,11236,40.640965,-73.911427,5.6,"SFR,PERMANENT LIVING",A2,RR101,1,,9159,10746,19905,202000,237000,439000,2017
68E6A257-730B-E811-80C3-3863BB430E3F,11234,40.604669,-73.911391,0.4,"SFR,PERMANENT LIVING",A2,RR101,1,,23640,30180,53820,394000,503000,897000,2017
4DC39B57-730B-E811-80C3-3863BB430E3F,11236,40.645518,-73.91139,6.9,"SFR,PERMANENT LIVING",A2,RR101,1,,5417,11331,16748,120000,251000,371000,2017
86E2C157-730B-E811-80C3-3863BB430E3F,11234,40.613557,-73.911372,2.7,"SFR,PERMANENT LIVING",A2,RR101,1,,13416,28056,41472,307000,642000,949000,2017
E76FA557-730B-E811-80C3-3863BB430E3F,11234,40.604321,-73.91137,0.3,"SFR,PERMANENT LIVING",A2,RR101,1,,21543,33216,54759,371000,572000,943000,2017
4F5EBD57-730B-E811-80C3-3863BB430E3F,11234,40.615735,-73.911348,2.7,"SFR,PERMANENT LIVING",A2,RR101,1,,11929,21171,33100,253000,449000,702000,2017
B22BAA57-730B-E811-80C3-3863BB430E3F,11234,40.605639,-73.91134,0.7,"SFR,PERMANENT LIVING",A2,RR101,1,,19396,33455,52851,327000,564000,891000,2017
64649957-730B-E811-80C3-3863BB430E3F,11234,40.605281,-73.911326,0.7,"SFR,PERMANENT LIVING",A2,RR101,1,,17335,30530,47865,293000,516000,809000,2017
8470D757-730B-E811-80C3-3863BB430E3F,11234,40.604391,-73.911261,0.3,"SFR,PERMANENT LIVING",A2,RR101,1,,21485,33274,54759,370000,573000,943000,2017
A68CA557-730B-E811-80C3-3863BB430E3F,11234,40.613452,-73.911255,2.6,"SFR,PERMANENT LIVING",A2,RR101,1,,13050,24927,37977,334000,638000,972000,2017
0675CB57-730B-E811-80C3-3863BB430E3F,11234,40.615631,-73.911232,2.7,"SFR,PERMANENT LIVING",A2,RR101,1,,11917,20307,32224,250000,426000,676000,2017
5D7D9957-730B-E811-80C3-3863BB430E3F,11234,40.605351,-73.911217,0.7,"SFR,PERMANENT LIVING",A2,RR101,1,,17419,30513,47932,294000,515000,809000,2017
AE54D057-730B-E811-80C3-3863BB430E3F,11234,40.615141,-73.911153,2.8,"SFR,PERMANENT LIVING",A2,RR101,1,,14679,24753,39432,290000,489000,779000,2017
AF09B657-730B-E811-80C3-3863BB430E3F,11234,40.604462,-73.911152,0.4,"SFR,PERMANENT LIVING",A2,RR101,1,,21369,33390,54759,368000,575000,943000,2017
7341BD57-730B-E811-80C3-3863BB430E3F,11234,40.613348,-73.91114,2.6,"SFR,PERMANENT LIVING",A2,RR101,1,,12684,25652,38336,314000,635000,949000,2017
175DBD57-730B-E811-80C3-3863BB430E3F,11236,40.642446,-73.91112,5.8,"SFR,PERMANENT LIVING",A2,RR101,1,,20661,15909,36570,426000,328000,754000,2017
1CB4D257-730B-E811-80C3-3863BB430E3F,11234,40.615526,-73.911115,2.8,"SFR,PERMANENT LIVING",A2,RR101,1,,8853,18248,27101,213000,439000,652000,2017
4BCDB357-730B-E811-80C3-3863BB430E3F,11234,40.60643,-73.911098,0.7,"SFR,PERMANENT LIVING",A2,RR101,1,,16980,30720,47700,283000,512000,795000,2017
02D7CD57-730B-E811-80C3-3863BB430E3F,11236,40.643321,-73.911055,6,"SINGLE FAM RES,ATTAC",A5,RR101,1,,7243,15537,22780,179000,384000,563000,2017
8C4DAA57-730B-E811-80C3-3863BB430E3F,11234,40.604603,-73.910933,0.4,"SFR,PERMANENT LIVING",A2,RR101,1,,21079,33680,54759,363000,580000,943000,2017
D23BAA57-730B-E811-80C3-3863BB430E3F,11234,40.613146,-73.910916,2.5,LARGE SUBURBAN RESID,A3,RR101,1,,12251,23936,36187,325000,635000,960000,2017
84C6CB57-730B-E811-80C3-3863BB430E3F,11234,40.616448,-73.910913,2.7,"SINGLE FAM RES,ATTAC",A5,RR101,1,,11561,27674,39235,226000,541000,767000,2017
CC8CA557-730B-E811-80C3-3863BB430E3F,11234,40.606931,-73.910889,0.7,"SFR,PERMANENT LIVING",A2,RR101,1,,20190,27338,47528,370000,501000,871000,2017
D7ACB357-730B-E811-80C3-3863BB430E3F,11234,40.606574,-73.910877,0.5,"SFR,PERMANENT LIVING",A2,RR101,1,,16127,30861,46988,278000,532000,810000,2017
FC37DC57-730B-E811-80C3-3863BB430E3F,11234,40.612494,-73.910842,2.5,"SFR,PERMANENT LIVING",A2,RR101,1,,12188,26867,39055,313000,690000,1003000,2017
CCCFD957-730B-E811-80C3-3863BB430E3F,11234,40.613034,-73.910811,2.5,"SFR,PERMANENT LIVING",A2,RR101,1,,15630,21991,37621,376000,529000,905000,2017
EE83B857-730B-E811-80C3-3863BB430E3F,11234,40.613034,-73.910811,2.5,"SFR,PERMANENT LIVING",A2,RR101,1,,15630,21991,37621,376000,529000,905000,2017
42A8CB57-730B-E811-80C3-3863BB430E3F,11234,40.606644,-73.910767,0.5,"SFR,PERMANENT LIVING",A2,RR101,1,,16287,30364,46651,280000,522000,802000,2017
B62BAA57-730B-E811-80C3-3863BB430E3F,11236,40.638795,-73.910764,4.4,"SFR,PERMANENT LIVING",A2,RR101,1,,11869,9236,21105,257000,200000,457000,2017
5B49BD57-730B-E811-80C3-3863BB430E3F,11234,40.614101,-73.910755,2.6,"SFR,PERMANENT LIVING",A2,RR101,1,,17674,21381,39055,329000,398000,727000,2017
E8CFAE57-730B-E811-80C3-3863BB430E3F,11234,40.612923,-73.910714,2.5,"SFR,PERMANENT LIVING",A2,RR101,1,,13804,23459,37263,326000,554000,880000,2017
D7F39B57-730B-E811-80C3-3863BB430E3F,11234,40.607077,-73.910663,0.6,"SFR,PERMANENT LIVING",A2,RR101,1,,20056,28078,48134,360000,504000,864000,2017
C861C457-730B-E811-80C3-3863BB430E3F,11234,40.614574,-73.910658,2.6,"SFR,PERMANENT LIVING",A2,RR101,1,,15682,20812,36494,324000,430000,754000,2017
C0FBD457-730B-E811-80C3-3863BB430E3F,11234,40.606048,-73.910653,0.5,"SFR,PERMANENT LIVING",A2,RR101,1,,16466,47106,63572,345000,987000,1332000,2017
128DB857-730B-E811-80C3-3863BB430E3F,11234,40.613996,-73.910638,2.6,"SFR,PERMANENT LIVING",A2,RR101,1,,17186,20791,37977,329000,398000,727000,2017
4EA9CB57-730B-E811-80C3-3863BB430E3F,11236,40.64087,-73.910617,5.7,"SFR,PERMANENT LIVING",A2,RR101,1,,12103,22559,34662,257000,479000,736000,2017
7414D557-730B-E811-80C3-3863BB430E3F,11234,40.603769,-73.910586,0.1,"SFR,PERMANENT LIVING",A2,RR101,1,,29071,35991,65062,521000,645000,1166000,2017
C5D6B357-730B-E811-80C3-3863BB430E3F,11234,40.606128,-73.910557,0.4,"SFR,PERMANENT LIVING",A2,RR101,1,,12507,44257,56764,286000,1012000,1298000,2017
8215C957-730B-E811-80C3-3863BB430E3F,11236,40.639022,-73.910553,4.5,"SFR,PERMANENT LIVING",A2,RR101,1,,7743,10477,18220,187000,253000,440000,2017
83BE9B57-730B-E811-80C3-3863BB430E3F,11234,40.607762,-73.910546,0.9,"SINGLE FAM RES, DETA",A1,RR101,1,,26700,28500,55200,445000,475000,920000,2017
1ECAA057-730B-E811-80C3-3863BB430E3F,11234,40.604884,-73.910498,0.4,"SFR,PERMANENT LIVING",A2,RR101,1,,22260,34320,56580,371000,572000,943000,2017
E64EC457-730B-E811-80C3-3863BB430E3F,11234,40.606856,-73.910441,0.4,"SFR,PERMANENT LIVING",A2,RR101,1,,15675,30100,45775,276000,530000,806000,2017
5678AC57-730B-E811-80C3-3863BB430E3F,11234,40.614754,-73.910403,2.7,"SFR,PERMANENT LIVING",A2,RR101,1,,17113,22662,39775,330000,437000,767000,2017
A290CB57-730B-E811-80C3-3863BB430E3F,11236,40.64474,-73.910342,6.7,"SFR,PERMANENT LIVING",A2,RR101,1,,10766,6626,17392,221000,136000,357000,2017
5BFEB557-730B-E811-80C3-3863BB430E3F,11234,40.606928,-73.910332,0.4,"SFR,PERMANENT LIVING",A2,RR101,1,,12588,33658,46246,279000,746000,1025000,2017
98DBD957-730B-E811-80C3-3863BB430E3F,11236,40.638398,-73.910322,4.3,"SFR,PERMANENT LIVING",A2,RR101,1,,5398,10365,15763,138000,265000,403000,2017
87C09B57-730B-E811-80C3-3863BB430E3F,11234,40.613234,-73.910301,2.4,LARGE SUBURBAN RESID,A3,RR101,1,,19939,19473,39412,385000,376000,761000,2017
C2F1CD57-730B-E811-80C3-3863BB430E3F,11236,40.638792,-73.910297,4.3,"SFR,PERMANENT LIVING",A2,RR101,1,,9413,9217,18630,239000,234000,473000,2017
5E86CB57-730B-E811-80C3-3863BB430E3F,11236,40.641678,-73.910287,5.8,"SFR,PERMANENT LIVING",A2,RR101,1,,5910,8151,14061,153000,211000,364000,2017
D705AF57-730B-E811-80C3-3863BB430E3F,11234,40.609199,-73.910252,2,"SFR,PERMANENT LIVING",A2,RR101,1,,11498,28811,40309,263000,659000,922000,2017
08F8C157-730B-E811-80C3-3863BB430E3F,11234,40.603852,-73.910243,0.1,"SFR,PERMANENT LIVING",A2,RR101,1,,21089,38695,59784,436000,800000,1236000,2017
405BA557-730B-E811-80C3-3863BB430E3F,11236,40.637113,-73.91021,2.7,"SFR,PERMANENT LIVING",A2,RR101,1,,7599,10393,17992,155000,212000,367000,2017
D82A9E57-730B-E811-80C3-3863BB430E3F,11234,40.615812,-73.910208,2.9,"SFR,PERMANENT LIVING",A2,RR101,1,,11735,21019,32754,249000,446000,695000,2017
7DA3B357-730B-E811-80C3-3863BB430E3F,11234,40.613578,-73.910173,2.4,"SINGLE FAM RES, DETA",A1,RR101,1,,15043,37742,52785,336000,843000,1179000,2017
3CE3BF57-730B-E811-80C3-3863BB430E3F,11234,40.604429,-73.910125,0.2,"SFR,PERMANENT LIVING",A2,RR101,1,,19473,35922,55395,354000,653000,1007000,2017
7A9FCB57-730B-E811-80C3-3863BB430E3F,11234,40.615733,-73.91012,2.9,"SFR,PERMANENT LIVING",A2,RR101,1,,10404,28023,38427,225000,606000,831000,2017
E855C457-730B-E811-80C3-3863BB430E3F,11234,40.606354,-73.910108,0.1,"SFR,PERMANENT LIVING",A2,RR101,1,,22869,42725,65594,478000,893000,1371000,2017
02C7A057-730B-E811-80C3-3863BB430E3F,11236,40.641471,-73.910057,5.8,"SFR,PERMANENT LIVING",A2,RR101,1,,3402,11985,15387,134000,472000,606000,2017
6C7ECB57-730B-E811-80C3-3863BB430E3F,11234,40.612808,-73.909992,2.4,"SFR,PERMANENT LIVING",A2,RR101,1,,17933,24346,42279,344000,467000,811000,2017
FC82A557-730B-E811-80C3-3863BB430E3F,11234,40.613356,-73.909967,2.4,"SFR,PERMANENT LIVING",A2,RR101,1,,17444,20892,38336,334000,400000,734000,2017
6E4CC457-730B-E811-80C3-3863BB430E3F,11234,40.615564,-73.909933,2.9,"SFR,PERMANENT LIVING",A2,RR101,1,,12241,29219,41460,261000,623000,884000,2017
0B08AF57-730B-E811-80C3-3863BB430E3F,11236,40.642338,-73.909923,6,"SFR,PERMANENT LIVING",A2,RR101,1,,5362,9716,15078,117000,212000,329000,2017
201AD557-730B-E811-80C3-3863BB430E3F,11234,40.603936,-73.9099,0.1,"SFR,PERMANENT LIVING",A2,RR101,1,,19334,41213,60547,395000,842000,1237000,2017
D872AC57-730B-E811-80C3-3863BB430E3F,11234,40.609674,-73.909898,2,"SFR,PERMANENT LIVING",A2,RR101,1,,12442,28199,40641,274000,621000,895000,2017
8CD4CB57-730B-E811-80C3-3863BB430E3F,11234,40.605186,-73.909888,0.3,"SINGLE FAM RES, DETA",A1,RR101,1,,28305,38602,66907,525000,716000,1241000,2017
A62EDC57-730B-E811-80C3-3863BB430E3F,11234,40.607309,-73.909814,0.4,"SFR,PERMANENT LIVING",A2,RR101,1,,13944,29606,43550,260000,552000,812000,2017
EAA7CB57-730B-E811-80C3-3863BB430E3F,11236,40.642214,-73.909782,6.1,"SFR,PERMANENT LIVING",A2,RR101,1,,6322,11358,17680,118000,212000,330000,2017
6611C957-730B-E811-80C3-3863BB430E3F,11234,40.60987,-73.909774,2.1,"SFR,PERMANENT LIVING",A2,RR101,1,,13123,27186,40309,307000,636000,943000,2017
865A9957-730B-E811-80C3-3863BB430E3F,11234,40.603978,-73.909728,0.1,"SFR,PERMANENT LIVING",A2,RR101,1,,17703,42081,59784,366000,870000,1236000,2017
6333BD57-730B-E811-80C3-3863BB430E3F,11234,40.607389,-73.909716,0.5,"SFR,PERMANENT LIVING",A2,RR101,1,,14205,29210,43415,266000,547000,813000,2017
4074D757-730B-E811-80C3-3863BB430E3F,11234,40.609023,-73.909712,1.8,LARGE SUBURBAN RESID,A3,RR101,1,,11851,29070,40921,265000,650000,915000,2017
FA24DC57-730B-E811-80C3-3863BB430E3F,11234,40.609975,-73.90971,2.2,"SFR,PERMANENT LIVING",A2,RR101,1,,11602,28707,40309,272000,673000,945000,2017
1E19C257-730B-E811-80C3-3863BB430E3F,11234,40.61213,-73.909706,2.4,"SFR,PERMANENT LIVING",A2,RR101,1,,16467,22228,38695,343000,463000,806000,2017
861AC957-730B-E811-80C3-3863BB430E3F,11236,40.646728,-73.909694,7.1,"SFR,PERMANENT LIVING",A2,RR101,1,,12981,27266,40247,299000,628000,927000,2017
07D1BA57-730B-E811-80C3-3863BB430E3F,11234,40.611992,-73.909672,2.4,"SINGLE FAM RES, DETA",A1,RR101,1,,15568,27173,42741,389000,679000,1068000,2017
B0F9A257-730B-E811-80C3-3863BB430E3F,11234,40.607469,-73.909621,0.5,"SFR,PERMANENT LIVING",A2,RR101,1,,13848,29567,43415,259000,553000,812000,2017
AAAFBF57-730B-E811-80C3-3863BB430E3F,11234,40.614109,-73.90954,2.6,"SFR,PERMANENT LIVING",A2,RR101,1,,14954,23023,37977,328000,505000,833000,2017
CEA9D257-730B-E811-80C3-3863BB430E3F,11234,40.607552,-73.909525,0.5,"SFR,PERMANENT LIVING",A2,RR101,1,,13773,29574,43347,258000,554000,812000,2017
5ABFCB57-730B-E811-80C3-3863BB430E3F,11234,40.612593,-73.909488,2.4,"SFR,PERMANENT LIVING",A2,RR101,1,,16328,22008,38336,345000,465000,810000,2017
A480AC57-730B-E811-80C3-3863BB430E3F,11234,40.609409,-73.909425,2.1,"SFR,PERMANENT LIVING",A2,RR101,1,,12777,29829,42606,275000,642000,917000,2017
8835D557-730B-E811-80C3-3863BB430E3F,11234,40.609508,-73.909359,2.2,"SFR,PERMANENT LIVING",A2,RR101,1,,13995,29084,43079,307000,638000,945000,2017
14DEBF57-730B-E811-80C3-3863BB430E3F,11234,40.607722,-73.909339,0.7,LARGE SUBURBAN RESID,A3,RR101,1,,18120,31620,49740,302000,527000,829000,2017
B9F3AE57-730B-E811-80C3-3863BB430E3F,11234,40.613339,-73.909294,2.4,"SFR,PERMANENT LIVING",A2,RR101,1,,15638,22653,38291,301000,436000,737000,2017
2DFBB557-730B-E811-80C3-3863BB430E3F,11234,40.611947,-73.909291,2.4,"SFR,PERMANENT LIVING",A2,RR101,1,,14577,24118,38695,327000,541000,868000,2017
6295A057-730B-E811-80C3-3863BB430E3F,11236,40.639662,-73.909274,4.8,"SFR,PERMANENT LIVING",A2,RR101,1,,7651,10263,17914,211000,283000,494000,2017
2BD39B57-730B-E811-80C3-3863BB430E3F,11234,40.611268,-73.90927,2.3,"SFR,PERMANENT LIVING",A2,RR101,1,,12900,29401,42301,301000,686000,987000,2017
2854D057-730B-E811-80C3-3863BB430E3F,11234,40.611813,-73.909268,2.4,"SFR,PERMANENT LIVING",A2,RR101,1,,18324,24485,42809,351000,469000,820000,2017
3F0AB657-730B-E811-80C3-3863BB430E3F,11234,40.614538,-73.909256,2.7,"SFR,PERMANENT LIVING",A2,RR101,1,,15293,29740,45033,307000,597000,904000,2017
A689AC57-730B-E811-80C3-3863BB430E3F,11234,40.613782,-73.909223,2.5,"SFR,PERMANENT LIVING",A2,RR101,1,,15462,22965,38427,305000,453000,758000,2017
174FB157-730B-E811-80C3-3863BB430E3F,11236,40.639602,-73.909201,4.7,"SFR,PERMANENT LIVING",A2,RR101,1,,4375,9955,14330,120000,273000,393000,2017
7041D057-730B-E811-80C3-3863BB430E3F,11236,40.646817,-73.909174,7,"SFR,PERMANENT LIVING",A2,RR101,1,,12912,13918,26830,257000,277000,534000,2017
1257A557-730B-E811-80C3-3863BB430E3F,11234,40.609816,-73.909173,2.4,"SFR,PERMANENT LIVING",A2,RR101,1,,12571,29564,42135,273000,642000,915000,2017
804DAA57-730B-E811-80C3-3863BB430E3F,11234,40.607285,-73.909103,0.3,"SFR,PERMANENT LIVING",A2,RR101,1,,12896,36182,49078,324000,909000,1233000,2017
D471D757-730B-E811-80C3-3863BB430E3F,11234,40.607285,-73.909103,0.3,"SFR,PERMANENT LIVING",A2,RR101,1,,12896,36182,49078,324000,909000,1233000,2017
EB64A557-730B-E811-80C3-3863BB430E3F,11234,40.614793,-73.909072,2.7,"SFR,PERMANENT LIVING",A2,RR101,1,,19163,35378,54541,364000,672000,1036000,2017
544FC457-730B-E811-80C3-3863BB430E3F,11236,40.638761,-73.909026,4.3,"SFR,PERMANENT LIVING",A2,RR101,1,,6270,11463,17733,134000,245000,379000,2017
D53FB157-730B-E811-80C3-3863BB430E3F,11236,40.647252,-73.909013,7.1,"SFR,PERMANENT LIVING",A2,RR101,1,,8645,13721,22366,172000,273000,445000,2017
BE309E57-730B-E811-80C3-3863BB430E3F,11236,40.640695,-73.909001,5.8,"SFR,PERMANENT LIVING",A2,RR101,1,,4998,11720,16718,119000,279000,398000,2017
BA5CD757-730B-E811-80C3-3863BB430E3F,11234,40.607214,-73.908978,0.3,"SFR,PERMANENT LIVING",A2,RR101,1,,12152,35510,47662,308000,900000,1208000,2017
501EDC57-730B-E811-80C3-3863BB430E3F,11234,40.608158,-73.9089,1.3,"SFR,PERMANENT LIVING",A2,RR101,1,,12638,29562,42200,292000,683000,975000,2017
960EC957-730B-E811-80C3-3863BB430E3F,11236,40.640768,-73.908896,5.8,"SFR,PERMANENT LIVING",A2,RR101,1,,4746,11760,16506,113000,280000,393000,2017
5A81A557-730B-E811-80C3-3863BB430E3F,11236,40.630314,-73.908866,1.5,"SFR,PERMANENT LIVING",A2,RR101,1,,6944,10044,16988,168000,243000,411000,2017
BAB1A057-730B-E811-80C3-3863BB430E3F,11234,40.607147,-73.908865,0.2,"SFR,PERMANENT LIVING",A2,RR101,1,,13548,36811,50359,325000,883000,1208000,2017
070CB657-730B-E811-80C3-3863BB430E3F,11234,40.607493,-73.908859,0.5,"SFR,PERMANENT LIVING",A2,RR101,1,,12820,36258,49078,320000,905000,1225000,2017
15C6B357-730B-E811-80C3-3863BB430E3F,11234,40.608247,-73.90882,1.4,"SFR,PERMANENT LIVING",A2,RR101,1,,12682,29518,42200,293000,682000,975000,2017
1E8DC457-730B-E811-80C3-3863BB430E3F,11236,40.63628,-73.908804,2.7,"SFR,PERMANENT LIVING",A2,RR101,1,,11993,10579,22572,212000,187000,399000,2017
24B1BF57-730B-E811-80C3-3863BB430E3F,11236,40.639201,-73.90876,4.3,"SINGLE FAM RES, DETA",A1,RR101,1,,12344,26197,38541,262000,556000,818000,2017
F114C255-730B-E811-80C3-3863BB430E3F,11234,40.607101,-73.90872,0.2,"SFR,PERMANENT LIVING",A2,RR101,1,,12902,37322,50224,326000,943000,1269000,2017
A0F3C157-730B-E811-80C3-3863BB430E3F,11234,40.614003,-73.908719,2.7,"SFR,PERMANENT LIVING",A2,RR101,1,,15463,29325,44788,309000,586000,895000,2017
8C61D757-730B-E811-80C3-3863BB430E3F,11234,40.60743,-73.908711,0.5,"SFR,PERMANENT LIVING",A2,RR101,1,,18200,34901,53101,328000,629000,957000,2017
0EFBD457-730B-E811-80C3-3863BB430E3F,11234,40.611136,-73.908705,2.5,"SFR,PERMANENT LIVING",A2,RR101,1,,14930,27371,42301,300000,550000,850000,2017
2C25D557-730B-E811-80C3-3863BB430E3F,11234,40.613015,-73.908697,2.4,"SFR,PERMANENT LIVING",A2,RR101,1,,12971,31909,44880,313000,770000,1083000,2017
2227AA57-730B-E811-80C3-3863BB430E3F,11234,40.608427,-73.908662,1.7,"SFR,PERMANENT LIVING",A2,RR101,1,,12682,29518,42200,293000,682000,975000,2017
C214C257-730B-E811-80C3-3863BB430E3F,11234,40.60852,-73.908589,1.9,"SFR,PERMANENT LIVING",A2,RR101,1,,12778,29422,42200,291000,670000,961000,2017
D7749957-730B-E811-80C3-3863BB430E3F,11236,40.634944,-73.908555,4.1,"SFR,PERMANENT LIVING",A2,RR101,1,,5050,6772,11822,176000,236000,412000,2017
6ECFCB57-730B-E811-80C3-3863BB430E3F,11234,40.61263,-73.908524,2.4,"SFR,PERMANENT LIVING",A2,RR101,1,,16403,23367,39770,325000,463000,788000,2017
580ED557-730B-E811-80C3-3863BB430E3F,11236,40.647041,-73.90852,7,"SFR,PERMANENT LIVING",A2,RR101,1,,8726,13090,21816,206000,309000,515000,2017
820BD557-730B-E811-80C3-3863BB430E3F,11234,40.607851,-73.908497,1,"SFR,PERMANENT LIVING",A2,RR101,1,,18242,38184,56426,408000,854000,1262000,2017
7D71A557-730B-E811-80C3-3863BB430E3F,11234,40.6125,-73.908479,2.4,"SFR,PERMANENT LIVING",A2,RR101,1,,16255,23157,39412,325000,463000,788000,2017
6A8ECB57-730B-E811-80C3-3863BB430E3F,11234,40.607332,-73.908452,0.6,"SFR,PERMANENT LIVING",A2,RR101,1,,19680,39000,58680,328000,650000,978000,2017
B321BD57-730B-E811-80C3-3863BB430E3F,11234,40.608704,-73.908445,2.1,"SFR,PERMANENT LIVING",A2,RR101,1,,12941,29259,42200,299000,676000,975000,2017
5CCEBF57-730B-E811-80C3-3863BB430E3F,11234,40.608799,-73.908375,2.3,"SFR,PERMANENT LIVING",A2,RR101,1,,12985,29215,42200,300000,675000,975000,2017
1FA4B357-730B-E811-80C3-3863BB430E3F,11234,40.610978,-73.908363,2.6,LARGE SUBURBAN RESID,A3,RR101,1,,11180,28932,40112,279000,722000,1001000,2017
04B1D257-730B-E811-80C3-3863BB430E3F,11234,40.614937,-73.908361,2.6,LARGE SUBURBAN RESID,A3,RR101,1,,28740,32160,60900,479000,536000,1015000,2017
BE56D757-730B-E811-80C3-3863BB430E3F,11234,40.60683,-73.908337,0.2,"SFR,PERMANENT LIVING",A2,RR101,1,,15319,37534,52853,311000,762000,1073000,2017
BE43C457-730B-E811-80C3-3863BB430E3F,11234,40.607784,-73.908329,1,"SFR,PERMANENT LIVING",A2,RR101,1,,23167,34877,58044,548000,825000,1373000,2017
2CDEAE57-730B-E811-80C3-3863BB430E3F,11234,40.608893,-73.908308,2.4,"SFR,PERMANENT LIVING",A2,RR101,1,,13262,28938,42200,302000,659000,961000,2017
3880A557-730B-E811-80C3-3863BB430E3F,11236,40.639887,-73.908278,4.7,"SINGLE FAM RES,ATTAC",A5,RR101,1,,8074,18892,26966,156000,365000,521000,2017
7FBF9B57-730B-E811-80C3-3863BB430E3F,11236,40.639837,-73.908235,4.7,"SINGLE FAM RES,ATTAC",A5,RR101,1,,6743,17593,24336,156000,407000,563000,2017
8A89C457-730B-E811-80C3-3863BB430E3F,11234,40.609086,-73.90818,2.7,"SFR,PERMANENT LIVING",A2,RR101,1,,13028,29172,42200,301000,674000,975000,2017
6F3BB157-730B-E811-80C3-3863BB430E3F,11236,40.635253,-73.908133,3.3,"SFR,PERMANENT LIVING",A2,RR101,1,,6884,7446,14330,208000,225000,433000,2017
86319E57-730B-E811-80C3-3863BB430E3F,11234,40.613767,-73.90812,2.6,"SFR,PERMANENT LIVING",A2,RR101,1,,17036,33053,50089,334000,648000,982000,2017
1486B857-730B-E811-80C3-3863BB430E3F,11236,40.638677,-73.908119,4.3,"SFR,PERMANENT LIVING",A2,RR101,1,,6323,12184,18507,192000,370000,562000,2017
6687A057-730B-E811-80C3-3863BB430E3F,11234,40.614911,-73.908112,2.5,LARGE SUBURBAN RESID,A3,RR101,1,,27258,31393,58651,468000,539000,1007000,2017
D2BEA057-730B-E811-80C3-3863BB430E3F,11236,40.639711,-73.908094,4.5,"SINGLE FAM RES,ATTAC",A5,RR101,1,,7417,18071,25488,165000,402000,567000,2017
9413C957-730B-E811-80C3-3863BB430E3F,11234,40.609281,-73.908061,2.9,"SFR,PERMANENT LIVING",A2,RR101,1,,12552,29648,42200,290000,685000,975000,2017
2C8AA557-730B-E811-80C3-3863BB430E3F,11234,40.614629,-73.90801,2.8,"SINGLE FAM RES, DETA",A1,RR101,1,,24169,9615,33784,734000,292000,1026000,2017
1B019C57-730B-E811-80C3-3863BB430E3F,11234,40.608468,-73.907997,2.2,"SFR,PERMANENT LIVING",A2,RR101,1,,12645,29085,41730,290000,667000,957000,2017
9C4FC457-730B-E811-80C3-3863BB430E3F,11234,40.608468,-73.907997,2.2,"SFR,PERMANENT LIVING",A2,RR101,1,,12645,29085,41730,290000,667000,957000,2017
E6B2CB57-730B-E811-80C3-3863BB430E3F,11236,40.641129,-73.907967,5.7,"SFR,PERMANENT LIVING",A2,RR101,1,,6289,15207,21496,158000,382000,540000,2017
FC64B857-730B-E811-80C3-3863BB430E3F,11234,40.609479,-73.907947,3,"SFR,PERMANENT LIVING",A2,RR101,1,,11902,30298,42200,275000,700000,975000,2017
B247A557-730B-E811-80C3-3863BB430E3F,11234,40.607655,-73.907923,1,"SFR,PERMANENT LIVING",A2,RR101,1,,16000,31999,47999,301000,602000,903000,2017
7082B857-730B-E811-80C3-3863BB430E3F,11236,40.643145,-73.907909,6.2,"SFR,PERMANENT LIVING",A2,RR101,1,,19140,10434,29574,321000,175000,496000,2017
4307AF57-730B-E811-80C3-3863BB430E3F,11234,40.614513,-73.907901,2.8,"SFR,PERMANENT LIVING",A2,RR101,1,,25709,25391,51100,484000,478000,962000,2017
2016AF57-730B-E811-80C3-3863BB430E3F,11234,40.607156,-73.907893,0.7,"SFR,PERMANENT LIVING",A2,RR101,1,,17945,36863,54808,332000,682000,1014000,2017
E3A6B357-730B-E811-80C3-3863BB430E3F,11234,40.608415,-73.907846,2.3,"SFR,PERMANENT LIVING",A2,RR101,1,,11285,28759,40044,268000,683000,951000,2017
BEC5CB57-730B-E811-80C3-3863BB430E3F,11234,40.610688,-73.907835,2.8,"SINGLE FAM,CITY RESI",A4,RR101,1,,14598,33536,48134,296000,680000,976000,2017
E219AF57-730B-E811-80C3-3863BB430E3F,11234,40.613273,-73.907824,2.5,"SFR,PERMANENT LIVING",A2,RR101,1,,15226,32706,47932,304000,653000,957000,2017
B63AD057-730B-E811-80C3-3863BB430E3F,11234,40.608709,-73.907821,2.7,"SFR,PERMANENT LIVING",A2,RR101,1,,14798,31179,45977,318000,670000,988000,2017
4AE3C157-730B-E811-80C3-3863BB430E3F,11236,40.634277,-73.907808,2.7,"SFR,PERMANENT LIVING",A2,RR101,1,,9607,15234,24841,268000,425000,693000,2017
6E10AA57-730B-E811-80C3-3863BB430E3F,11234,40.611232,-73.907753,2.5,"SINGLE FAM,CITY RESI",A4,RR101,1,,11508,27997,39505,268000,652000,920000,2017
7473B857-730B-E811-80C3-3863BB430E3F,11234,40.611532,-73.907746,2.4,LARGE SUBURBAN RESID,A3,RR101,1,,18577,34208,52785,353000,650000,1003000,2017
9EE0BF57-730B-E811-80C3-3863BB430E3F,11234,40.611375,-73.907746,2.5,"SINGLE FAM,CITY RESI",A4,RR101,1,,16395,28125,44520,348000,597000,945000,2017
92D3BF57-730B-E811-80C3-3863BB430E3F,11234,40.606424,-73.90765,0.1,"SFR,PERMANENT LIVING",A2,RR101,1,,17549,41355,58904,418000,985000,1403000,2017
CEEFBF57-730B-E811-80C3-3863BB430E3F,11234,40.610103,-73.907646,3.2,LARGE SUBURBAN RESID,A3,RR101,1,,16250,34063,50313,343000,719000,1062000,2017
D16AA557-730B-E811-80C3-3863BB430E3F,11236,40.644978,-73.907636,6.4,"SFR,PERMANENT LIVING",A2,RR101,1,,9932,12587,22519,187000,237000,424000,2017
D77F9957-730B-E811-80C3-3863BB430E3F,11234,40.607147,-73.90761,0.8,"SFR,PERMANENT LIVING",A2,RR101,1,,18200,34901,53101,328000,629000,957000,2017
C476C457-730B-E811-80C3-3863BB430E3F,11234,40.610243,-73.907594,3.2,"SINGLE FAM,CITY RESI",A4,RR101,1,,14222,28250,42472,291000,578000,869000,2017
1E47D057-730B-E811-80C3-3863BB430E3F,11234,40.607862,-73.907512,1.7,"SFR,PERMANENT LIVING",A2,RR101,1,,11479,29981,41460,255000,666000,921000,2017
3803D557-730B-E811-80C3-3863BB430E3F,11234,40.606414,-73.907494,0.1,"SFR,PERMANENT LIVING",A2,RR101,1,,17166,39628,56794,415000,958000,1373000,2017
7067D757-730B-E811-80C3-3863BB430E3F,11234,40.607578,-73.90748,1.3,"SFR,PERMANENT LIVING",A2,RR101,1,,13939,35948,49887,323000,833000,1156000,2017
68A8BF57-730B-E811-80C3-3863BB430E3F,11234,40.610672,-73.907471,2.9,"SINGLE FAM,CITY RESI",A4,RR101,1,,15370,35056,50426,317000,723000,1040000,2017
B553B157-730B-E811-80C3-3863BB430E3F,11234,40.608291,-73.907447,2.4,"SFR,PERMANENT LIVING",A2,RR101,1,,11718,28394,40112,267000,647000,914000,2017
2F4DB157-730B-E811-80C3-3863BB430E3F,11234,40.612166,-73.907441,2.4,"SFR,PERMANENT LIVING",A2,RR101,1,,12871,34049,46920,299000,791000,1090000,2017
B6C3BF57-730B-E811-80C3-3863BB430E3F,11234,40.613775,-73.907423,2.7,LARGE SUBURBAN RESID,A3,RR101,1,,17738,35924,53662,316000,640000,956000,2017
F410C957-730B-E811-80C3-3863BB430E3F,11234,40.611107,-73.9074,2.7,"SINGLE FAM,CITY RESI",A4,RR101,1,,12983,27601,40584,278000,591000,869000,2017
EEA6D257-730B-E811-80C3-3863BB430E3F,11234,40.611247,-73.907388,2.6,"SFR,PERMANENT LIVING",A2,RR101,1,,17854,28007,45861,364000,571000,935000,2017
A5C99B57-730B-E811-80C3-3863BB430E3F,11234,40.607846,-73.907369,1.8,"SFR,PERMANENT LIVING",A2,RR101,1,,11562,30033,41595,256000,665000,921000,2017
3C9EA057-730B-E811-80C3-3863BB430E3F,11234,40.607566,-73.907331,1.4,"SFR,PERMANENT LIVING",A2,RR101,1,,16818,32327,49145,308000,592000,900000,2017
62BEBF57-730B-E811-80C3-3863BB430E3F,11234,40.607123,-73.907329,0.9,"SFR,PERMANENT LIVING",A2,RR101,1,,18726,35745,54471,329000,628000,957000,2017
F48EAC57-730B-E811-80C3-3863BB430E3F,11234,40.613571,-73.907304,2.7,"SFR,PERMANENT LIVING",A2,RR101,1,,15394,28156,43550,275000,503000,778000,2017
DE26C957-730B-E811-80C3-3863BB430E3F,11234,40.609317,-73.907233,3.6,"SFR,PERMANENT LIVING",A2,RR101,1,,19379,32395,51774,335000,560000,895000,2017
84F7C157-730B-E811-80C3-3863BB430E3F,11234,40.607118,-73.907182,0.9,"SFR,PERMANENT LIVING",A2,RR101,1,,15792,34702,50494,309000,679000,988000,2017
8AA2A057-730B-E811-80C3-3863BB430E3F,11236,40.639958,-73.907172,4.8,"SFR,PERMANENT LIVING",A2,RR101,1,,10936,10169,21105,228000,212000,440000,2017
5C6AD757-730B-E811-80C3-3863BB430E3F,11234,40.609278,-73.90709,3.8,"SFR,PERMANENT LIVING",A2,RR101,1,,12684,28978,41662,267000,610000,877000,2017
5C80A057-730B-E811-80C3-3863BB430E3F,11234,40.607834,-73.907088,2,"SFR,PERMANENT LIVING",A2,RR101,1,,12672,30878,43550,268000,653000,921000,2017
205DA557-730B-E811-80C3-3863BB430E3F,11234,40.613032,-73.907049,2.6,"SFR,PERMANENT LIVING",A2,RR101,1,,12059,16251,28310,256000,345000,601000,2017
E63B9E57-730B-E811-80C3-3863BB430E3F,11236,40.634388,-73.907024,2.5,"SFR,PERMANENT LIVING",A2,RR101,1,,6836,8569,15405,217000,272000,489000,2017
F6209E57-730B-E811-80C3-3863BB430E3F,11234,40.608255,-73.907018,2.8,"SFR,PERMANENT LIVING",A2,RR101,1,,15051,30858,45909,319000,654000,973000,2017
D94BBD57-730B-E811-80C3-3863BB430E3F,11234,40.612921,-73.907009,2.6,"SFR,PERMANENT LIVING",A2,RR101,1,,11272,20143,31415,230000,411000,641000,2017
D5E89B57-730B-E811-80C3-3863BB430E3F,11236,40.645437,-73.90692,6.6,"SFR,PERMANENT LIVING",A2,RR101,1,,9931,14551,24482,187000,274000,461000,2017
FC03D557-730B-E811-80C3-3863BB430E3F,11236,40.642986,-73.90691,5.9,"SFR,PERMANENT LIVING",A2,RR101,1,,12403,7659,20062,251000,155000,406000,2017
053DB157-730B-E811-80C3-3863BB430E3F,11234,40.609683,-73.906875,4,"SFR,PERMANENT LIVING",A2,RR101,1,,14412,25528,39940,306000,542000,848000,2017
8A0FD557-730B-E811-80C3-3863BB430E3F,11234,40.606852,-73.906801,0.7,"SFR,PERMANENT LIVING",A2,RR101,1,,11590,38634,50224,303000,1010000,1313000,2017
10E7BF57-730B-E811-80C3-3863BB430E3F,11236,40.633899,-73.906778,2,"SFR,PERMANENT LIVING",A2,RR101,1,,13315,13407,26722,289000,291000,580000,2017
F0AACB57-730B-E811-80C3-3863BB430E3F,11234,40.607577,-73.906732,1.9,"SFR,PERMANENT LIVING",A2,RR101,1,,15397,32805,48202,314000,669000,983000,2017
6119B657-730B-E811-80C3-3863BB430E3F,11234,40.609945,-73.906715,4,"SFR,PERMANENT LIVING",A2,RR101,1,,13305,32739,46044,293000,721000,1014000,2017
6312C255-730B-E811-80C3-3863BB430E3F,11234,40.607862,-73.906666,2.5,"SFR,PERMANENT LIVING",A2,RR101,1,,12672,30878,43550,268000,653000,921000,2017
7B54BD57-730B-E811-80C3-3863BB430E3F,11234,40.620094,-73.906658,2.7,"SFR,PERMANENT LIVING",A2,RR101,1,,17260,26829,44089,294000,457000,751000,2017
B864D757-730B-E811-80C3-3863BB430E3F,11234,40.606864,-73.90665,0.7,"SFR,PERMANENT LIVING",A2,RR101,1,,15931,37814,53745,348000,826000,1174000,2017
370CB657-730B-E811-80C3-3863BB430E3F,11234,40.609605,-73.90659,4.1,"SFR,PERMANENT LIVING",A2,RR101,1,,9905,26499,36404,237000,634000,871000,2017
FA2D9E57-730B-E811-80C3-3863BB430E3F,11234,40.607594,-73.906586,2,"SFR,PERMANENT LIVING",A2,RR101,1,,13558,33767,47325,318000,792000,1110000,2017
DA5D9957-730B-E811-80C3-3863BB430E3F,11234,40.610385,-73.906531,3.7,"SFR,PERMANENT LIVING",A2,RR101,1,,14922,35706,50628,308000,737000,1045000,2017
24E4AE57-730B-E811-80C3-3863BB430E3F,11234,40.608626,-73.906507,3.7,"SFR,PERMANENT LIVING",A2,RR101,1,,15050,29242,44292,316000,614000,930000,2017
13C9B357-730B-E811-80C3-3863BB430E3F,11234,40.609832,-73.906457,4.1,"SINGLE FAM RES, DETA",A1,RR101,1,,42324,28939,71263,936000,640000,1576000,2017
7449A557-730B-E811-80C3-3863BB430E3F,11236,40.638228,-73.906448,4.3,"SFR,PERMANENT LIVING",A2,RR101,1,,5744,12170,17914,143000,303000,446000,2017
96CFCD57-730B-E811-80C3-3863BB430E3F,11234,40.618781,-73.906434,2.4,"SINGLE FAM RES, DETA",A1,RR101,1,,11695,27270,38965,229000,534000,763000,2017
6215C257-730B-E811-80C3-3863BB430E3F,11234,40.61186,-73.90641,2.4,"SFR,PERMANENT LIVING",A2,RR101,1,,12926,27658,40584,265000,567000,832000,2017
2C1CC957-730B-E811-80C3-3863BB430E3F,11234,40.608356,-73.906409,3.5,"SFR,PERMANENT LIVING",A2,RR101,1,,22075,36576,58651,408000,676000,1084000,2017
4BC99B57-730B-E811-80C3-3863BB430E3F,11234,40.620997,-73.906401,2.7,"SINGLE FAM RES,ATTAC",A5,RR101,1,,8535,20925,29460,166000,407000,573000,2017
B0AABF57-730B-E811-80C3-3863BB430E3F,11236,40.638124,-73.906332,4.3,"SFR,PERMANENT LIVING",A2,RR101,1,,6071,11662,17733,177000,340000,517000,2017
05BFB357-730B-E811-80C3-3863BB430E3F,11234,40.610611,-73.90633,3.4,"SFR,PERMANENT LIVING",A2,RR101,1,,20544,35275,55819,371000,637000,1008000,2017
5A95D257-730B-E811-80C3-3863BB430E3F,11234,40.621099,-73.906248,2.7,"SINGLE FAM RES,ATTAC",A5,RR101,1,,8347,20641,28988,165000,408000,573000,2017
B88BB857-730B-E811-80C3-3863BB430E3F,11234,40.611343,-73.906226,2.6,"SFR,PERMANENT LIVING",A2,RR101,1,,20240,36861,57101,369000,672000,1041000,2017
FBF6B557-730B-E811-80C3-3863BB430E3F,11234,40.611045,-73.906192,2.9,"SFR,PERMANENT LIVING",A2,RR101,1,,18563,39481,58044,347000,738000,1085000,2017
2495B857-730B-E811-80C3-3863BB430E3F,11234,40.621208,-73.906084,2.7,"SINGLE FAM RES, DETA",A1,RR101,1,,16860,27000,43860,281000,450000,731000,2017
314CB157-730B-E811-80C3-3863BB430E3F,11234,40.607989,-73.906066,3.2,"SFR,PERMANENT LIVING",A2,RR101,1,,15254,33824,49078,299000,663000,962000,2017
FE51A557-730B-E811-80C3-3863BB430E3F,11234,40.608528,-73.90604,4,"SFR,PERMANENT LIVING",A2,RR101,1,,17724,35129,52853,334000,662000,996000,2017
A1BBB357-730B-E811-80C3-3863BB430E3F,11234,40.61177,-73.906037,2.5,"SFR,PERMANENT LIVING",A2,RR101,1,,16998,38349,55347,332000,749000,1081000,2017
DD06AF57-730B-E811-80C3-3863BB430E3F,11234,40.610458,-73.906019,3.7,"SFR,PERMANENT LIVING",A2,RR101,1,,18839,38868,57707,364000,751000,1115000,2017
B902B657-730B-E811-80C3-3863BB430E3F,11236,40.642646,-73.90597,5.8,"SFR,PERMANENT LIVING",A2,RR101,1,,8609,17932,26541,169000,352000,521000,2017
FE37AA57-730B-E811-80C3-3863BB430E3F,11234,40.607733,-73.905946,2.8,"SFR,PERMANENT LIVING",A2,RR101,1,,12778,30569,43347,283000,677000,960000,2017
0F03B657-730B-E811-80C3-3863BB430E3F,11234,40.608597,-73.905937,4.2,"SFR,PERMANENT LIVING",A2,RR101,1,,11157,27808,38965,258000,643000,901000,2017
95D39B57-730B-E811-80C3-3863BB430E3F,11234,40.607267,-73.905879,1.9,LARGE SUBURBAN RESID,A3,RR101,1,,25164,44391,69555,445000,785000,1230000,2017
965EB857-730B-E811-80C3-3863BB430E3F,11234,40.611224,-73.905857,2.7,"SFR,PERMANENT LIVING",A2,RR101,1,,17288,32397,49685,333000,624000,957000,2017
E3C29B57-730B-E811-80C3-3863BB430E3F,11234,40.607783,-73.905812,3,"SFR,PERMANENT LIVING",A2,RR101,1,,17509,32108,49617,319000,585000,904000,2017
06E2CD57-730B-E811-80C3-3863BB430E3F,11234,40.608104,-73.905806,3.6,"SFR,PERMANENT LIVING",A2,RR101,1,,15254,33824,49078,299000,663000,962000,2017
B15BA557-730B-E811-80C3-3863BB430E3F,11234,40.611975,-73.90572,2.6,"SFR,PERMANENT LIVING",A2,RR101,1,,24780,43511,68291,422000,741000,1163000,2017
E0C5CB57-730B-E811-80C3-3863BB430E3F,11234,40.610817,-73.905686,3.4,"SFR,PERMANENT LIVING",A2,RR101,1,,11510,32647,44157,269000,763000,1032000,2017
DA48AA57-730B-E811-80C3-3863BB430E3F,11234,40.620824,-73.905677,2.7,LARGE SUBURBAN RESID,A3,RR101,1,,17134,29720,46854,324000,562000,886000,2017
3E13C957-730B-E811-80C3-3863BB430E3F,11236,40.638518,-73.905539,4.3,"SINGLE FAM RES,ATTAC",A5,RR101,1,,8294,20554,28848,159000,394000,553000,2017
426AD757-730B-E811-80C3-3863BB430E3F,11234,40.607422,-73.905472,2.5,"SFR,PERMANENT LIVING",A2,RR101,1,,19183,40143,59326,367000,768000,1135000,2017
068ACB57-730B-E811-80C3-3863BB430E3F,11236,40.63106,-73.905457,1.5,"SINGLE FAM RES,ATTAC",A5,RR101,1,,9274,16613,25887,182000,326000,508000,2017
436DA557-730B-E811-80C3-3863BB430E3F,11234,40.609255,-73.905457,4.4,"SFR,PERMANENT LIVING",A2,RR101,1,,26007,41868,67875,464000,747000,1211000,2017
E8E3C157-730B-E811-80C3-3863BB430E3F,11234,40.617179,-73.905407,2.1,"SFR,PERMANENT LIVING",A2,RR101,1,,11930,24946,36876,264000,552000,816000,2017
50C7CB57-730B-E811-80C3-3863BB430E3F,11234,40.606374,-73.905362,0.7,"SFR,PERMANENT LIVING",A2,RR101,1,,13453,38801,52254,345000,995000,1340000,2017
C152B157-730B-E811-80C3-3863BB430E3F,11234,40.608043,-73.905333,3.8,"SFR,PERMANENT LIVING",A2,RR101,1,,17192,32493,49685,309000,584000,893000,2017
560FAA57-730B-E811-80C3-3863BB430E3F,11234,40.607503,-73.905303,2.7,"SFR,PERMANENT LIVING",A2,RR101,1,,10727,32957,43684,290000,891000,1181000,2017
8812AA57-730B-E811-80C3-3863BB430E3F,11234,40.618276,-73.905277,2.6,"SFR,PERMANENT LIVING",A2,RR101,1,,15824,18624,34448,277000,326000,603000,2017
EF4ABD57-730B-E811-80C3-3863BB430E3F,11234,40.605073,-73.90527,0.1,"SFR,PERMANENT LIVING",A2,RR101,1,,16149,50862,67011,388000,1222000,1610000,2017
8755BD57-730B-E811-80C3-3863BB430E3F,11234,40.606465,-73.905099,0.9,"SFR,PERMANENT LIVING",A2,RR101,1,,14136,41251,55387,342000,998000,1340000,2017
3EC4D957-730B-E811-80C3-3863BB430E3F,11234,40.610757,-73.905098,3.4,LARGE SUBURBAN RESID,A3,RR101,1,,22140,45060,67200,369000,751000,1120000,2017
2ED0CB57-730B-E811-80C3-3863BB430E3F,11234,40.610114,-73.905003,4.1,"SFR,PERMANENT LIVING",A2,RR101,1,,12248,33122,45370,274000,741000,1015000,2017
B62CDC57-730B-E811-80C3-3863BB430E3F,11234,40.608381,-73.904945,4.3,"SFR,PERMANENT LIVING",A2,RR101,1,,17275,32545,49820,310000,584000,894000,2017
1ED9BF57-730B-E811-80C3-3863BB430E3F,11234,40.609109,-73.904909,4.6,"SFR,PERMANENT LIVING",A2,RR101,1,,20156,37821,57977,372000,698000,1070000,2017
D02D9E57-730B-E811-80C3-3863BB430E3F,11234,40.610556,-73.904897,3.5,"SFR,PERMANENT LIVING",A2,RR101,1,,23678,40568,64246,429000,735000,1164000,2017
D6D5BF57-730B-E811-80C3-3863BB430E3F,11234,40.611233,-73.904888,2.3,"SFR,PERMANENT LIVING",A2,RR101,1,,17104,38446,55550,335000,753000,1088000,2017
4CF2BF57-730B-E811-80C3-3863BB430E3F,11236,40.64197,-73.904874,5.5,"SFR,PERMANENT LIVING",A2,RR101,1,,9084,6770,15854,161000,120000,281000,2017
960BD557-730B-E811-80C3-3863BB430E3F,11234,40.609559,-73.904852,4.6,"SFR,PERMANENT LIVING",A2,RR101,1,,16072,32871,48943,309000,632000,941000,2017
0FFAAE57-730B-E811-80C3-3863BB430E3F,11234,40.605861,-73.904831,0.5,"SFR,PERMANENT LIVING",A2,RR101,1,,21755,36271,58026,535000,892000,1427000,2017
0DEE9B57-730B-E811-80C3-3863BB430E3F,11234,40.6087,-73.904713,4.5,"SFR,PERMANENT LIVING",A2,RR101,1,,24184,37501,61685,454000,704000,1158000,2017
F0DCCB57-730B-E811-80C3-3863BB430E3F,11234,40.610014,-73.904586,4.2,"SFR,PERMANENT LIVING",A2,RR101,1,,15784,35586,51370,326000,735000,1061000,2017
03F39B57-730B-E811-80C3-3863BB430E3F,11234,40.60973,-73.90451,4.5,"SFR,PERMANENT LIVING",A2,RR101,1,,15982,33568,49550,329000,691000,1020000,2017
86699957-730B-E811-80C3-3863BB430E3F,11234,40.609313,-73.904505,4.7,"SFR,PERMANENT LIVING",A2,RR101,1,,17714,33656,51370,340000,646000,986000,2017
F9D4BA57-730B-E811-80C3-3863BB430E3F,11234,40.609592,-73.904497,4.6,LARGE SUBURBAN RESID,A3,RR101,1,,15784,35586,51370,326000,735000,1061000,2017
90DBD957-730B-E811-80C3-3863BB430E3F,11234,40.620296,-73.904424,2.8,"SINGLE FAM RES, DETA",A1,RR101,1,,8454,30848,39302,228000,832000,1060000,2017
1A4FC457-730B-E811-80C3-3863BB430E3F,11234,40.619596,-73.90441,2.8,"SFR,PERMANENT LIVING",A2,RR101,1,,8870,17691,26561,182000,363000,545000,2017
0A309E57-730B-E811-80C3-3863BB430E3F,11234,40.61846,-73.904371,2.9,"SFR,PERMANENT LIVING",A2,RR101,1,,10181,21705,31886,220000,469000,689000,2017
89D79B57-730B-E811-80C3-3863BB430E3F,11234,40.606817,-73.904358,1.6,"SFR,PERMANENT LIVING",A2,RR101,1,,12385,36895,49280,286000,852000,1138000,2017
7C87CB57-730B-E811-80C3-3863BB430E3F,11234,40.606084,-73.904325,0.7,"SFR,PERMANENT LIVING",A2,RR101,1,,19575,40786,60361,491000,1023000,1514000,2017
FA91A557-730B-E811-80C3-3863BB430E3F,11236,40.642884,-73.904275,5.5,"SINGLE FAM RES,ATTAC",A5,RR101,1,,2848,6275,9123,108000,238000,346000,2017
6248A557-730B-E811-80C3-3863BB430E3F,11234,40.618354,-73.904254,2.9,"SFR,PERMANENT LIVING",A2,RR101,1,,17820,40680,58500,297000,678000,975000,2017
6058A557-730B-E811-80C3-3863BB430E3F,11236,40.635068,-73.904159,2.6,"SFR,PERMANENT LIVING",A2,RR101,1,,6803,7378,14181,154000,167000,321000,2017
B463C457-730B-E811-80C3-3863BB430E3F,11234,40.610387,-73.904135,2.8,LARGE SUBURBAN RESID,A3,RR101,1,,13265,36352,49617,339000,929000,1268000,2017
0E27D557-730B-E811-80C3-3863BB430E3F,11234,40.610961,-73.904128,1.3,LARGE SUBURBAN RESID,A3,RR101,1,,23983,41073,65056,428000,733000,1161000,2017
442EC257-730B-E811-80C3-3863BB430E3F,11234,40.610241,-73.904066,3.1,"SFR,PERMANENT LIVING",A2,RR101,1,,15153,33587,48740,314000,696000,1010000,2017
13ECAE57-730B-E811-80C3-3863BB430E3F,11234,40.610098,-73.904008,3.4,"SFR,PERMANENT LIVING",A2,RR101,1,,15586,33762,49348,319000,691000,1010000,2017
1835D057-730B-E811-80C3-3863BB430E3F,11234,40.609946,-73.903965,3.6,"SFR,PERMANENT LIVING",A2,RR101,1,,15642,34582,50224,332000,734000,1066000,2017
2CAEA057-730B-E811-80C3-3863BB430E3F,11234,40.609183,-73.903941,4.4,"SFR,PERMANENT LIVING",A2,RR101,1,,16091,34808,50899,337000,729000,1066000,2017
8E54AA57-730B-E811-80C3-3863BB430E3F,11234,40.609794,-73.903936,3.9,"SFR,PERMANENT LIVING",A2,RR101,1,,15957,35076,51033,328000,721000,1049000,2017
D2E9BF57-730B-E811-80C3-3863BB430E3F,11236,40.642034,-73.903923,5.1,"SFR,PERMANENT LIVING",A2,RR101,1,,10080,10020,20100,168000,167000,335000,2017
AAE5AE57-730B-E811-80C3-3863BB430E3F,11234,40.605421,-73.903861,0.1,"SFR,PERMANENT LIVING",A2,RR101,1,,12503,38396,50899,338000,1038000,1376000,2017
B0DFAE57-730B-E811-80C3-3863BB430E3F,11234,40.621307,-73.903759,2.7,"SFR,PERMANENT LIVING",A2,RR101,1,,11375,26242,37617,241000,556000,797000,2017
2A09C957-730B-E811-80C3-3863BB430E3F,11234,40.608775,-73.903696,3.7,LARGE SUBURBAN RESID,A3,RR101,1,,22713,40707,63420,409000,733000,1142000,2017
46F6D457-730B-E811-80C3-3863BB430E3F,11234,40.610189,-73.903669,2.5,"SFR,PERMANENT LIVING",A2,RR101,1,,23633,41953,65586,476000,845000,1321000,2017
FA87A057-730B-E811-80C3-3863BB430E3F,11234,40.608926,-73.903644,3.7,"SFR,PERMANENT LIVING",A2,RR101,1,,14333,35419,49752,312000,771000,1083000,2017
49E39B57-730B-E811-80C3-3863BB430E3F,11234,40.610053,-73.903627,2.7,"SFR,PERMANENT LIVING",A2,RR101,1,,16389,37813,54202,332000,766000,1098000,2017
2490A057-730B-E811-80C3-3863BB430E3F,11234,40.609067,-73.903605,3.7,"SFR,PERMANENT LIVING",A2,RR101,1,,15437,34450,49887,328000,732000,1060000,2017
06CFD957-730B-E811-80C3-3863BB430E3F,11234,40.609344,-73.903562,3.7,"SFR,PERMANENT LIVING",A2,RR101,1,,15239,34311,49550,326000,734000,1060000,2017
5415D557-730B-E811-80C3-3863BB430E3F,11234,40.609487,-73.903555,3.5,LARGE SUBURBAN RESID,A3,RR101,1,,15259,34358,49617,326000,734000,1060000,2017
68F2A257-730B-E811-80C3-3863BB430E3F,11234,40.620028,-73.903551,2.9,"SINGLE FAM RES, DETA",A1,RR101,1,,19310,39987,59297,353000,731000,1084000,2017
A894D257-730B-E811-80C3-3863BB430E3F,11236,40.644118,-73.903546,6,"SFR,PERMANENT LIVING",A2,RR101,1,,15120,3420,18540,252000,57000,309000,2017
EC98CB57-730B-E811-80C3-3863BB430E3F,11236,40.644241,-73.9035,6.1,"SFR,PERMANENT LIVING",A2,RR101,1,,12840,4800,17640,214000,80000,294000,2017
63A3B357-730B-E811-80C3-3863BB430E3F,11234,40.606548,-73.903498,1.1,"SFR,PERMANENT LIVING",A2,RR101,1,,12655,37105,49760,353000,1035000,1388000,2017
2820D557-730B-E811-80C3-3863BB430E3F,11234,40.606025,-73.903408,0.6,"SFR,PERMANENT LIVING",A2,RR101,1,,21377,45478,66855,479000,1019000,1498000,2017
F889CB57-730B-E811-80C3-3863BB430E3F,11234,40.61065,-73.903294,0.9,LARGE SUBURBAN RESID,A3,RR101,1,,24615,43541,68156,424000,750000,1174000,2017
150FC255-730B-E811-80C3-3863BB430E3F,11234,40.616834,-73.903181,2.1,"SINGLE FAM RES, DETA",A1,RR101,1,,13818,25754,39572,257000,479000,736000,2017
1C0EC957-730B-E811-80C3-3863BB430E3F,11234,40.607921,-73.903138,1.9,"SFR,PERMANENT LIVING",A2,RR101,1,,11895,39947,51842,307000,1031000,1338000,2017
8A68D757-730B-E811-80C3-3863BB430E3F,11234,40.620243,-73.903048,2.8,"SINGLE FAM RES, DETA",A1,RR101,1,,13715,25780,39495,291000,547000,838000,2017
8EC9A057-730B-E811-80C3-3863BB430E3F,11234,40.605623,-73.903045,0.1,"SFR,PERMANENT LIVING",A2,RR101,1,,12503,38396,50899,338000,1038000,1376000,2017
A544BD57-730B-E811-80C3-3863BB430E3F,11234,40.606485,-73.903044,1.2,"SFR,PERMANENT LIVING",A2,RR101,1,,18803,44497,63300,464000,1098000,1562000,2017
82D7BF57-730B-E811-80C3-3863BB430E3F,11234,40.606344,-73.903032,1,"SFR,PERMANENT LIVING",A2,RR101,1,,24833,48309,73142,512000,996000,1508000,2017
AB9FB357-730B-E811-80C3-3863BB430E3F,11234,40.608237,-73.902946,1.5,"SFR,PERMANENT LIVING",A2,RR101,1,,15617,39461,55078,355000,897000,1252000,2017
F747B157-730B-E811-80C3-3863BB430E3F,11236,40.644323,-73.902934,6.1,"SFR,PERMANENT LIVING",A2,RR101,1,,7113,8950,16063,120000,151000,271000,2017
61059C57-730B-E811-80C3-3863BB430E3F,11234,40.609741,-73.902909,1.3,LARGE SUBURBAN RESID,A3,RR101,1,,28376,40185,68561,483000,684000,1167000,2017
E46BB857-730B-E811-80C3-3863BB430E3F,11236,40.644278,-73.902885,6.1,"SINGLE FAM RES,ATTAC",A5,RR101,1,,6625,8999,15624,120000,163000,283000,2017
BC4ED057-730B-E811-80C3-3863BB430E3F,11234,40.609509,-73.902878,1.3,"SINGLE FAM RES,ATTAC",A5,RR101,1,,27674,41831,69505,477000,721000,1198000,2017
8275CB57-730B-E811-80C3-3863BB430E3F,11236,40.644235,-73.902836,6.1,"SINGLE FAM RES,ATTAC",A5,RR101,1,,7080,9120,16200,118000,152000,270000,2017
724BD057-730B-E811-80C3-3863BB430E3F,11234,40.619115,-73.902638,2.9,"SFR,PERMANENT LIVING",A2,RR101,1,,19947,35535,55482,334000,595000,929000,2017
D3C59B57-730B-E811-80C3-3863BB430E3F,11236,40.640846,-73.902556,4.3,"SFR,PERMANENT LIVING",A2,RR101,1,,6200,9558,15758,120000,185000,305000,2017
6E89AC57-730B-E811-80C3-3863BB430E3F,11234,40.619768,-73.902522,2.8,"SFR,PERMANENT LIVING",A2,RR101,1,,20123,41764,61887,358000,743000,1101000,2017
F03ADC57-730B-E811-80C3-3863BB430E3F,11234,40.617987,-73.902517,2.6,"SINGLE FAM RES,ATTAC",A5,RR101,1,,11689,25996,37685,210000,467000,677000,2017
0B0CB657-730B-E811-80C3-3863BB430E3F,11236,40.640804,-73.902509,4.3,"SFR,PERMANENT LIVING",A2,RR101,1,,6990,10428,17418,120000,179000,299000,2017
56C6D957-730B-E811-80C3-3863BB430E3F,11234,40.606738,-73.902428,1.3,"SFR,PERMANENT LIVING",A2,RR101,1,,14468,44183,58651,372000,1136000,1508000,2017
2C76B857-730B-E811-80C3-3863BB430E3F,11234,40.619661,-73.902403,2.8,"SFR,PERMANENT LIVING",A2,RR101,1,,11059,24872,35931,241000,542000,783000,2017
DE1DDC57-730B-E811-80C3-3863BB430E3F,11234,40.617881,-73.902399,2.5,"SINGLE FAM RES,ATTAC",A5,RR101,1,,10803,24454,35257,220000,498000,718000,2017
CCBCD957-730B-E811-80C3-3863BB430E3F,11234,40.606196,-73.90236,1.2,"SFR,PERMANENT LIVING",A2,RR101,1,,12503,38396,50899,338000,1038000,1376000,2017
E90DB657-730B-E811-80C3-3863BB430E3F,11234,40.615213,-73.902314,1.8,"SINGLE FAM RES, DETA",A1,RR101,1,,15223,27707,42930,289000,526000,815000,2017
2CDDCB57-730B-E811-80C3-3863BB430E3F,11234,40.619947,-73.902243,2.7,"SFR,PERMANENT LIVING",A2,RR101,1,,19534,33319,52853,333000,568000,901000,2017
D6C4BF57-730B-E811-80C3-3863BB430E3F,11234,40.617183,-73.902203,2.3,"SFR,PERMANENT LIVING",A2,RR101,1,,18193,25087,43280,314000,433000,747000,2017
6E91A057-730B-E811-80C3-3863BB430E3F,11236,40.63668,-73.90208,4.2,"SFR,PERMANENT LIVING",A2,RR101,1,,11280,11520,22800,188000,192000,380000,2017
BDBCBA57-730B-E811-80C3-3863BB430E3F,11234,40.618548,-73.902009,2.7,"SFR,PERMANENT LIVING",A2,RR101,1,,25080,22740,47820,418000,379000,797000,2017
C907AF57-730B-E811-80C3-3863BB430E3F,11236,40.63983,-73.901991,4.1,"SFR,PERMANENT LIVING",A2,RR101,1,,18856,19197,38053,332000,338000,670000,2017
6A24AA57-730B-E811-80C3-3863BB430E3F,11236,40.635766,-73.901987,3.7,"SFR,PERMANENT LIVING",A2,RR101,1,,8289,9103,17392,173000,190000,363000,2017
8610AA57-730B-E811-80C3-3863BB430E3F,11234,40.616933,-73.901924,2.2,"SINGLE FAM RES,ATTAC",A5,RR101,1,,14196,19241,33437,242000,328000,570000,2017
A6BBCB57-730B-E811-80C3-3863BB430E3F,11236,40.635643,-73.901859,3.6,"SFR,PERMANENT LIVING",A2,RR101,1,,8385,9209,17594,173000,190000,363000,2017
2CACA057-730B-E811-80C3-3863BB430E3F,11236,40.635526,-73.901728,3.6,"SFR,PERMANENT LIVING",A2,RR101,1,,8651,9752,18403,173000,195000,368000,2017
5297A057-730B-E811-80C3-3863BB430E3F,11234,40.617771,-73.901712,2.4,"SFR,PERMANENT LIVING",A2,RR101,1,,13613,24477,38090,322000,579000,901000,2017
854FB157-730B-E811-80C3-3863BB430E3F,11234,40.615025,-73.90163,1.8,"SFR,PERMANENT LIVING",A2,RR101,1,,12851,28204,41055,257000,564000,821000,2017
1A01A357-730B-E811-80C3-3863BB430E3F,11234,40.615749,-73.901478,1.9,"SFR,PERMANENT LIVING",A2,RR101,1,,13874,18552,32426,258000,345000,603000,2017
266EC457-730B-E811-80C3-3863BB430E3F,11236,40.636128,-73.901462,4,"SFR,PERMANENT LIVING",A2,RR101,1,,8541,9629,18170,165000,186000,351000,2017
26E7A257-730B-E811-80C3-3863BB430E3F,11236,40.646063,-73.901462,4.3,"SFR,PERMANENT LIVING",A2,RR101,1,,4867,8403,13270,95000,164000,259000,2017
F629C957-730B-E811-80C3-3863BB430E3F,11236,40.633035,-73.901418,2.7,"SFR,PERMANENT LIVING",A2,RR101,1,,7877,12247,20124,164000,255000,419000,2017
CFD1B357-730B-E811-80C3-3863BB430E3F,11236,40.6461,-73.901405,4.3,"SFR,PERMANENT LIVING",A2,RR101,1,,4802,8468,13270,93000,164000,257000,2017
885FB857-730B-E811-80C3-3863BB430E3F,11236,40.63607,-73.901401,4,"SFR,PERMANENT LIVING",A2,RR101,1,,9840,9960,19800,164000,166000,330000,2017
E308AF57-730B-E811-80C3-3863BB430E3F,11236,40.646134,-73.901351,4.3,"SFR,PERMANENT LIVING",A2,RR101,1,,4631,9800,14431,95000,201000,296000,2017
4BAAB357-730B-E811-80C3-3863BB430E3F,11236,40.636015,-73.90134,3.9,"SFR,PERMANENT LIVING",A2,RR101,1,,9229,9680,18909,164000,172000,336000,2017
1E0CAA57-730B-E811-80C3-3863BB430E3F,11234,40.616228,-73.901141,2,"SFR,PERMANENT LIVING",A2,RR101,1,,9740,17967,27707,206000,380000,586000,2017
97BCB357-730B-E811-80C3-3863BB430E3F,11236,40.632756,-73.901107,2.7,"SFR,PERMANENT LIVING",A2,RR101,1,,7367,12757,20124,164000,284000,448000,2017
6297BF57-730B-E811-80C3-3863BB430E3F,11236,40.635792,-73.901092,3.9,"SFR,PERMANENT LIVING",A2,RR101,1,,9421,10398,19819,164000,181000,345000,2017
21BABA57-730B-E811-80C3-3863BB430E3F,11236,40.632701,-73.901045,2.7,"SFR,PERMANENT LIVING",A2,RR101,1,,8671,12779,21450,171000,252000,423000,2017
C0D0AE57-730B-E811-80C3-3863BB430E3F,11236,40.633308,-73.900967,2.8,"SFR,PERMANENT LIVING",A2,RR101,1,,6583,12764,19347,164000,318000,482000,2017
EC88B857-730B-E811-80C3-3863BB430E3F,11236,40.633252,-73.900905,2.8,"SFR,PERMANENT LIVING",A2,RR101,1,,5248,9313,14561,142000,252000,394000,2017
2B12C255-730B-E811-80C3-3863BB430E3F,11234,40.616202,-73.900774,2.1,"SFR,PERMANENT LIVING",A2,RR101,1,,8164,18937,27101,194000,450000,644000,2017
E65EC457-730B-E811-80C3-3863BB430E3F,11234,40.615753,-73.900509,2,"SFR,PERMANENT LIVING",A2,RR101,1,,20449,23510,43959,354000,407000,761000,2017
5346BD57-730B-E811-80C3-3863BB430E3F,11236,40.631733,-73.900445,2.6,"SFR,PERMANENT LIVING",A2,RR101,1,,4943,8151,13094,131000,216000,347000,2017
D3BEB357-730B-E811-80C3-3863BB430E3F,11234,40.615559,-73.900386,2,"SFR,PERMANENT LIVING",A2,RR101,1,,16632,33322,49954,283000,567000,850000,2017
D9EDAE57-730B-E811-80C3-3863BB430E3F,11236,40.643549,-73.900386,6,"SFR,PERMANENT LIVING",A2,RR101,1,,10153,9918,20071,173000,169000,342000,2017
736EA557-730B-E811-80C3-3863BB430E3F,11234,40.618083,-73.900173,2.7,"SFR,PERMANENT LIVING",A2,RR101,1,,7151,18399,25550,185000,476000,661000,2017
8689A057-730B-E811-80C3-3863BB430E3F,11234,40.615736,-73.900112,2,"SFR,PERMANENT LIVING",A2,RR101,1,,15098,27440,42538,263000,478000,741000,2017
C0BEBF57-730B-E811-80C3-3863BB430E3F,11236,40.638121,-73.900027,4.7,"SFR,PERMANENT LIVING",A2,RR101,1,,6460,14118,20578,124000,271000,395000,2017
B116C255-730B-E811-80C3-3863BB430E3F,11236,40.645194,-73.899674,4.2,"SFR,PERMANENT LIVING",A2,RR101,1,,19140,2160,21300,319000,36000,355000,2017
C487AC57-730B-E811-80C3-3863BB430E3F,11234,40.617578,-73.899611,2.4,"SINGLE FAM RES, DETA",A1,RR101,1,,12285,26479,38764,238000,513000,751000,2017
0FEE9B57-730B-E811-80C3-3863BB430E3F,11236,40.63776,-73.899595,4.6,"SFR,PERMANENT LIVING",A2,RR101,1,,9301,10577,19878,175000,199000,374000,2017
1D20BD57-730B-E811-80C3-3863BB430E3F,11236,40.635523,-73.899569,3.9,"SFR,PERMANENT LIVING",A2,RR101,1,,9634,10768,20402,187000,209000,396000,2017
8242AA57-730B-E811-80C3-3863BB430E3F,11234,40.617494,-73.899517,2.4,"SINGLE FAM RES, DETA",A1,RR101,1,,12285,26479,38764,238000,513000,751000,2017
BB3DB157-730B-E811-80C3-3863BB430E3F,11234,40.617095,-73.899402,2.1,"SFR,PERMANENT LIVING",A2,RR101,1,,8229,21029,29258,189000,483000,672000,2017
4C60D757-730B-E811-80C3-3863BB430E3F,11234,40.617326,-73.89933,2.2,"SFR,PERMANENT LIVING",A2,RR101,1,,10030,26172,36202,233000,608000,841000,2017
FC71CB57-730B-E811-80C3-3863BB430E3F,11236,40.63534,-73.899315,3.8,"SFR,PERMANENT LIVING",A2,RR101,1,,14927,8059,22986,276000,149000,425000,2017
56EFA257-730B-E811-80C3-3863BB430E3F,11236,40.64476,-73.898694,4.2,"SFR,PERMANENT LIVING",A2,RR101,1,,16980,6900,23880,283000,115000,398000,2017
7207A357-730B-E811-80C3-3863BB430E3F,11236,40.638372,-73.898574,4.7,"SFR,PERMANENT LIVING",A2,RR101,1,,9260,9972,19232,182000,196000,378000,2017
EBEC9B57-730B-E811-80C3-3863BB430E3F,11236,40.638246,-73.898438,4.7,"SFR,PERMANENT LIVING",A2,RR101,1,,9434,9642,19076,182000,186000,368000,2017
6A2AAA57-730B-E811-80C3-3863BB430E3F,11236,40.639074,-73.898116,4.7,"SFR,PERMANENT LIVING",A2,RR101,1,,5500,7038,12538,143000,183000,326000,2017
4C8ABF57-730B-E811-80C3-3863BB430E3F,11236,40.635408,-73.897652,3.9,"SFR,PERMANENT LIVING",A2,RR101,1,,4996,9334,14330,91000,170000,261000,2017
A449A557-730B-E811-80C3-3863BB430E3F,11236,40.638883,-73.897621,4.6,"SFR,PERMANENT LIVING",A2,RR101,1,,6136,6522,12658,175000,186000,361000,2017
F528BD57-730B-E811-80C3-3863BB430E3F,11236,40.638825,-73.897555,4.6,"SFR,PERMANENT LIVING",A2,RR101,1,,7090,9359,16449,175000,231000,406000,2017
1E1CDC57-730B-E811-80C3-3863BB430E3F,11236,40.634147,-73.897508,3.6,"SFR,PERMANENT LIVING",A2,RR101,1,,11255,13406,24661,272000,324000,596000,2017
EEDDCD57-730B-E811-80C3-3863BB430E3F,11236,40.641191,-73.897401,4.5,"SINGLE FAM RES,ATTAC",A5,RR101,1,,8097,12262,20359,138000,209000,347000,2017
06CDA057-730B-E811-80C3-3863BB430E3F,11236,40.635654,-73.897389,4,"SFR,PERMANENT LIVING",A2,RR101,1,,4257,4699,8956,125000,138000,263000,2017
F6B6A057-730B-E811-80C3-3863BB430E3F,11236,40.638591,-73.897296,4.4,"SFR,PERMANENT LIVING",A2,RR101,1,,8174,9498,17672,173000,201000,374000,2017
7D0BC255-730B-E811-80C3-3863BB430E3F,11236,40.639224,-73.897258,4.5,"SFR,PERMANENT LIVING",A2,RR101,1,,8283,9577,17860,173000,200000,373000,2017
E4DDCB57-730B-E811-80C3-3863BB430E3F,11236,40.639189,-73.897161,4.5,"SFR,PERMANENT LIVING",A2,RR101,1,,10591,7920,18511,218000,163000,381000,2017
CD46BD57-730B-E811-80C3-3863BB430E3F,11236,40.633631,-73.897106,3.4,"SFR,PERMANENT LIVING",A2,RR101,1,,12312,14991,27303,262000,319000,581000,2017
A29EA057-730B-E811-80C3-3863BB430E3F,11236,40.633724,-73.896975,3.4,"SINGLE FAM RES, DETA",A1,RR101,1,,12340,18738,31078,272000,413000,685000,2017
D43AD057-730B-E811-80C3-3863BB430E3F,11236,40.639013,-73.896965,4.4,"SFR,PERMANENT LIVING",A2,RR101,1,,11224,7878,19102,218000,153000,371000,2017
2802C257-730B-E811-80C3-3863BB430E3F,11236,40.638954,-73.8969,4.4,"SFR,PERMANENT LIVING",A2,RR101,1,,10493,9242,19735,218000,192000,410000,2017
983ADC57-730B-E811-80C3-3863BB430E3F,11236,40.633348,-73.896854,3.4,"SFR,PERMANENT LIVING",A2,RR101,1,,13675,10122,23797,281000,208000,489000,2017
A876CB57-730B-E811-80C3-3863BB430E3F,11236,40.634573,-73.896784,3.7,"SFR,PERMANENT LIVING",A2,RR101,1,,11025,10373,21398,220000,207000,427000,2017
9858B857-730B-E811-80C3-3863BB430E3F,11236,40.631891,-73.896758,3,"SFR,PERMANENT LIVING",A2,RR101,1,,7698,12661,20359,197000,324000,521000,2017
55F2AE57-730B-E811-80C3-3863BB430E3F,11236,40.634496,-73.896681,3.6,"SFR,PERMANENT LIVING",A2,RR101,1,,8562,9370,17932,180000,197000,377000,2017
ACE3BF57-730B-E811-80C3-3863BB430E3F,11236,40.636204,-73.896642,4.3,"SFR,PERMANENT LIVING",A2,RR101,1,,18862,14147,33009,328000,246000,574000,2017
4CC9BF57-730B-E811-80C3-3863BB430E3F,11236,40.633525,-73.896521,3.3,"SFR,PERMANENT LIVING",A2,RR101,1,,8389,10542,18931,187000,235000,422000,2017
4483CB57-730B-E811-80C3-3863BB430E3F,11236,40.633473,-73.896438,3.3,"SFR,PERMANENT LIVING",A2,RR101,1,,9863,9231,19094,187000,175000,362000,2017
2820DC57-730B-E811-80C3-3863BB430E3F,11236,40.640067,-73.896114,4.1,"SFR,PERMANENT LIVING",A2,RR101,1,,9360,9516,18876,181000,184000,365000,2017
2B0AB657-730B-E811-80C3-3863BB430E3F,11236,40.634811,-73.89609,2.9,"SFR,PERMANENT LIVING",A2,RR101,1,,15983,10578,26561,343000,227000,570000,2017
F8C3D957-730B-E811-80C3-3863BB430E3F,11236,40.631718,-73.896083,2.9,"SFR,PERMANENT LIVING",A2,RR101,1,,11577,13096,24673,244000,276000,520000,2017
7C35DC57-730B-E811-80C3-3863BB430E3F,11236,40.639772,-73.895835,4.1,"SFR,PERMANENT LIVING",A2,RR101,1,,9665,9615,19280,192000,191000,383000,2017
7220C257-730B-E811-80C3-3863BB430E3F,11236,40.634672,-73.895683,2.7,"SFR,PERMANENT LIVING",A2,RR101,1,,5551,10695,16246,150000,289000,439000,2017
4A27AA57-730B-E811-80C3-3863BB430E3F,11236,40.640388,-73.895623,3.9,"SFR,PERMANENT LIVING",A2,RR101,1,,7643,8131,15774,157000,167000,324000,2017
E253C457-730B-E811-80C3-3863BB430E3F,11236,40.633838,-73.8956,2.9,"SFR,PERMANENT LIVING",A2,RR101,1,,10437,9517,19954,193000,176000,369000,2017
FB0CB657-730B-E811-80C3-3863BB430E3F,11236,40.634538,-73.895533,2.7,"SFR,PERMANENT LIVING",A2,RR101,1,,9007,11413,20420,191000,242000,433000,2017
8631D557-730B-E811-80C3-3863BB430E3F,11236,40.631215,-73.895522,2.9,"SFR,PERMANENT LIVING",A2,RR101,1,,14270,14381,28651,257000,259000,516000,2017
BA70B857-730B-E811-80C3-3863BB430E3F,11236,40.640217,-73.895435,3.8,"SFR,PERMANENT LIVING",A2,RR101,1,,7515,8394,15909,154000,172000,326000,2017
7911B657-730B-E811-80C3-3863BB430E3F,11236,40.635361,-73.895213,4.1,"SFR,PERMANENT LIVING",A2,RR101,1,,12628,7808,20436,262000,162000,424000,2017
8C95A057-730B-E811-80C3-3863BB430E3F,11236,40.64,-73.895193,3.8,"SFR,PERMANENT LIVING",A2,RR101,1,,8306,10175,18481,160000,196000,356000,2017
D7C0BA57-730B-E811-80C3-3863BB430E3F,11236,40.6353,-73.895151,4,"SFR,PERMANENT LIVING",A2,RR101,1,,3491,6554,10045,122000,229000,351000,2017
3F2FBD57-730B-E811-80C3-3863BB430E3F,11236,40.639891,-73.895072,3.8,"SFR,PERMANENT LIVING",A2,RR101,1,,7355,8419,15774,152000,174000,326000,2017
E81EAA57-730B-E811-80C3-3863BB430E3F,11236,40.638284,-73.894731,2.6,"SFR,PERMANENT LIVING",A2,RR101,1,,6199,8295,14494,142000,190000,332000,2017
CE34D557-730B-E811-80C3-3863BB430E3F,11236,40.638228,-73.89467,2.6,"SFR,PERMANENT LIVING",A2,RR101,1,,6054,8304,14358,140000,192000,332000,2017
A849C457-730B-E811-80C3-3863BB430E3F,11236,40.638175,-73.89461,2.6,"SFR,PERMANENT LIVING",A2,RR101,1,,7359,7751,15110,169000,178000,347000,2017
7166A557-730B-E811-80C3-3863BB430E3F,11236,40.639615,-73.894573,3.7,"SFR,PERMANENT LIVING",A2,RR101,1,,8333,9869,18202,152000,180000,332000,2017
DABFBF57-730B-E811-80C3-3863BB430E3F,11236,40.638071,-73.894495,3.1,"SFR,PERMANENT LIVING",A2,RR101,1,,6043,8383,14426,142000,197000,339000,2017
B422D557-730B-E811-80C3-3863BB430E3F,11236,40.639702,-73.894439,3.7,"SFR,PERMANENT LIVING",A2,RR101,1,,7929,12834,20763,139000,225000,364000,2017
A6B0CB57-730B-E811-80C3-3863BB430E3F,11236,40.639116,-73.894389,3.8,"SFR,PERMANENT LIVING",A2,RR101,1,,11820,10380,22200,197000,173000,370000,2017
3E19AA57-730B-E811-80C3-3863BB430E3F,11236,40.637965,-73.894377,3.9,"SFR,PERMANENT LIVING",A2,RR101,1,,5927,8230,14157,139000,193000,332000,2017
F5DDB357-730B-E811-80C3-3863BB430E3F,11236,40.639166,-73.894313,3.8,"SFR,PERMANENT LIVING",A2,RR101,1,,7357,10199,17556,145000,201000,346000,2017
AF38B157-730B-E811-80C3-3863BB430E3F,11236,40.639789,-73.894305,3.6,"SFR,PERMANENT LIVING",A2,RR101,1,,6710,8930,15640,139000,185000,324000,2017
DE50A557-730B-E811-80C3-3863BB430E3F,11236,40.639223,-73.894224,3.7,"SFR,PERMANENT LIVING",A2,RR101,1,,11408,9018,20426,210000,166000,376000,2017
490EAF57-730B-E811-80C3-3863BB430E3F,11236,40.639289,-73.894122,3.7,"SFR,PERMANENT LIVING",A2,RR101,1,,6665,9581,16246,160000,230000,390000,2017
E9F39B57-730B-E811-80C3-3863BB430E3F,11236,40.639341,-73.894041,3.7,"SFR,PERMANENT LIVING",A2,RR101,1,,7824,10920,18744,139000,194000,333000,2017
2E66C457-730B-E811-80C3-3863BB430E3F,11236,40.639384,-73.893974,3.6,"SFR,PERMANENT LIVING",A2,RR101,1,,7210,10789,17999,139000,208000,347000,2017
BA45A557-730B-E811-80C3-3863BB430E3F,11236,40.63739,-73.893737,4.3,"SFR,PERMANENT LIVING",A2,RR101,1,,8212,8871,17083,162000,175000,337000,2017
042DD557-730B-E811-80C3-3863BB430E3F,11236,40.637339,-73.893681,4.3,"SFR,PERMANENT LIVING",A2,RR101,1,,8381,9054,17435,162000,175000,337000,2017
ADD7B357-730B-E811-80C3-3863BB430E3F,11236,40.633529,-73.893656,2.7,"SFR,PERMANENT LIVING",A2,RR101,1,,5035,8312,13347,126000,208000,334000,2017
49DDB357-730B-E811-80C3-3863BB430E3F,11236,40.634589,-73.893613,2.7,"SFR,PERMANENT LIVING",A2,RR101,1,,7200,9388,16588,158000,206000,364000,2017
5F6E9957-730B-E811-80C3-3863BB430E3F,11236,40.635252,-73.893613,2.7,"SFR,PERMANENT LIVING",A2,RR101,1,,12724,21387,34111,260000,437000,697000,2017
80B6BF57-730B-E811-80C3-3863BB430E3F,11236,40.633487,-73.89361,2.7,"SFR,PERMANENT LIVING",A2,RR101,1,,4946,8401,13347,126000,214000,340000,2017
BAE3BF57-730B-E811-80C3-3863BB430E3F,11236,40.633487,-73.89361,2.7,"SFR,PERMANENT LIVING",A2,RR101,1,,4946,8401,13347,126000,214000,340000,2017
9FFF9B57-730B-E811-80C3-3863BB430E3F,11236,40.635085,-73.893423,2.7,"SFR,PERMANENT LIVING",A2,RR101,1,,13863,14316,28179,275000,284000,559000,2017
CD48BD57-730B-E811-80C3-3863BB430E3F,11236,40.634107,-73.893009,2.7,"SFR,PERMANENT LIVING",A2,RR101,1,,5095,7780,12875,131000,200000,331000,2017
DBB1B357-730B-E811-80C3-3863BB430E3F,11236,40.639032,-73.892884,3.4,"SFR,PERMANENT LIVING",A2,RR101,1,,9906,15644,25550,183000,289000,472000,2017
DC6EAC57-730B-E811-80C3-3863BB430E3F,11236,40.638862,-73.892695,3.3,"SFR,PERMANENT LIVING",A2,RR101,1,,8599,15265,23864,169000,300000,469000,2017
4BE99B57-730B-E811-80C3-3863BB430E3F,11236,40.638779,-73.892601,3.3,"SFR,PERMANENT LIVING",A2,RR101,1,,8551,15179,23730,169000,300000,469000,2017
DC82A557-730B-E811-80C3-3863BB430E3F,11236,40.636261,-73.89242,3.9,"SFR,PERMANENT LIVING",A2,RR101,1,,9443,9068,18511,226000,217000,443000,2017
7E5CD757-730B-E811-80C3-3863BB430E3F,11236,40.636475,-73.892118,3.6,"SFR,PERMANENT LIVING",A2,RR101,1,,5144,10159,15303,120000,237000,357000,2017
18B6CB57-730B-E811-80C3-3863BB430E3F,11236,40.637224,-73.892113,3.3,"SFR,PERMANENT LIVING",A2,RR101,1,,9311,12059,21370,200000,259000,459000,2017
EFC09B57-730B-E811-80C3-3863BB430E3F,11236,40.637953,-73.891837,3,"SFR,PERMANENT LIVING",A2,RR101,1,,11463,14896,26359,207000,269000,476000,2017
D24AA557-730B-E811-80C3-3863BB430E3F,11236,40.638097,-73.891612,3,"SINGLE FAM RES, DETA",A1,RR101,1,,9600,15681,25281,180000,294000,474000,2017
F11BB657-730B-E811-80C3-3863BB430E3F,11236,40.638169,-73.8915,2.9,"SFR,PERMANENT LIVING",A2,RR101,1,,9563,15919,25482,170000,283000,453000,2017
908ECB57-730B-E811-80C3-3863BB430E3F,11236,40.63886,-73.89142,2.9,"SFR,PERMANENT LIVING",A2,RR101,1,,7442,12243,19685,169000,278000,447000,2017
B817AA57-730B-E811-80C3-3863BB430E3F,11236,40.635025,-73.891041,3.1,"SFR,PERMANENT LIVING",A2,RR101,1,,6944,8359,15303,157000,189000,346000,2017
7D33B157-730B-E811-80C3-3863BB430E3F,11236,40.638487,-73.891011,2.7,"SFR,PERMANENT LIVING",A2,RR101,1,,8269,13505,21774,169000,276000,445000,2017
D719C255-730B-E811-80C3-3863BB430E3F,11236,40.634973,-73.890982,3.1,"SFR,PERMANENT LIVING",A2,RR101,1,,8576,8675,17251,175000,177000,352000,2017
8EEFCD57-730B-E811-80C3-3863BB430E3F,11236,40.634918,-73.890921,3.1,"SFR,PERMANENT LIVING",A2,RR101,1,,7489,11022,18511,176000,259000,435000,2017
A4C2D957-730B-E811-80C3-3863BB430E3F,11236,40.634806,-73.890796,3,"SFR,PERMANENT LIVING",A2,RR101,1,,7514,8260,15774,161000,177000,338000,2017
C7F6B557-730B-E811-80C3-3863BB430E3F,11236,40.638629,-73.890792,2.7,"SFR,PERMANENT LIVING",A2,RR101,1,,8597,13379,21976,169000,263000,432000,2017
434CBD57-730B-E811-80C3-3863BB430E3F,11236,40.634753,-73.890737,3,"SFR,PERMANENT LIVING",A2,RR101,1,,7150,8153,15303,157000,179000,336000,2017
B0FBD457-730B-E811-80C3-3863BB430E3F,11236,40.638702,-73.890678,2.7,"SFR,PERMANENT LIVING",A2,RR101,1,,11800,14403,26203,213000,260000,473000,2017
E074AC57-730B-E811-80C3-3863BB430E3F,11236,40.634699,-73.890677,2.9,"SFR,PERMANENT LIVING",A2,RR101,1,,8346,9114,17460,174000,190000,364000,2017
2853AA57-730B-E811-80C3-3863BB430E3F,11236,40.638497,-73.89059,2.7,"SINGLE FAM RES, DETA",A1,RR101,1,,10536,15620,26156,199000,295000,494000,2017
42A1BF57-730B-E811-80C3-3863BB430E3F,11236,40.64136,-73.890476,2.5,"SFR,PERMANENT LIVING",A2,RR101,1,,12660,15181,27841,226000,271000,497000,2017
82A2CB57-730B-E811-80C3-3863BB430E3F,11236,40.634482,-73.890434,2.9,"SFR,PERMANENT LIVING",A2,RR101,1,,7150,8153,15303,157000,179000,336000,2017
26A5D257-730B-E811-80C3-3863BB430E3F,11236,40.638952,-73.890301,2.6,"SFR,PERMANENT LIVING",A2,RR101,1,,6705,10687,17392,160000,255000,415000,2017
38C7CB57-730B-E811-80C3-3863BB430E3F,11236,40.63823,-73.890292,2.6,"SINGLE FAM RES, DETA",A1,RR101,1,,10675,15346,26021,192000,276000,468000,2017
C902B657-730B-E811-80C3-3863BB430E3F,11236,40.635515,-73.890206,2.7,"SFR,PERMANENT LIVING",A2,RR101,1,,6516,6562,13078,140000,141000,281000,2017
36D3CB57-730B-E811-80C3-3863BB430E3F,11236,40.638142,-73.890193,2.6,"SINGLE FAM RES, DETA",A1,RR101,1,,12275,16983,29258,206000,285000,491000,2017
48E9CD57-730B-E811-80C3-3863BB430E3F,11236,40.634266,-73.890193,2.9,"SFR,PERMANENT LIVING",A2,RR101,1,,7237,8200,15437,158000,179000,337000,2017
7850C457-730B-E811-80C3-3863BB430E3F,11236,40.638698,-73.890064,2.6,"SINGLE FAM RES, DETA",A1,RR101,1,,9795,16361,26156,185000,309000,494000,2017
4269C457-730B-E811-80C3-3863BB430E3F,11236,40.637971,-73.890002,2.6,"SINGLE FAM RES, DETA",A1,RR101,1,,8930,14800,23730,178000,295000,473000,2017
CCF5D457-730B-E811-80C3-3863BB430E3F,11236,40.639786,-73.889989,2.6,"SFR,PERMANENT LIVING",A2,RR101,1,,7372,12650,20022,169000,290000,459000,2017
A02FD557-730B-E811-80C3-3863BB430E3F,11236,40.635308,-73.889975,2.7,"SFR,PERMANENT LIVING",A2,RR101,1,,6229,15267,21496,153000,375000,528000,2017
9937BD57-730B-E811-80C3-3863BB430E3F,11236,40.639166,-73.88997,2.5,"SFR,PERMANENT LIVING",A2,RR101,1,,13500,16800,30300,225000,280000,505000,2017
C4F7C157-730B-E811-80C3-3863BB430E3F,11236,40.638957,-73.889878,2.5,"SINGLE FAM RES, DETA",A1,RR101,1,,10684,15135,25819,216000,306000,522000,2017
0C20C957-730B-E811-80C3-3863BB430E3F,11236,40.639858,-73.889877,2.6,"SFR,PERMANENT LIVING",A2,RR101,1,,7272,12480,19752,169000,290000,459000,2017
386FB857-730B-E811-80C3-3863BB430E3F,11236,40.638437,-73.889772,2.5,"SINGLE FAM RES, DETA",A1,RR101,1,,10054,16507,26561,187000,307000,494000,2017
D43ED057-730B-E811-80C3-3863BB430E3F,11236,40.639929,-73.889767,2.6,"SFR,PERMANENT LIVING",A2,RR101,1,,7272,12480,19752,169000,290000,459000,2017
0B0EAF57-730B-E811-80C3-3863BB430E3F,11236,40.637709,-73.889709,2.5,"SINGLE FAM RES, DETA",A1,RR101,1,,10148,15739,25887,187000,290000,477000,2017
D2DDCB57-730B-E811-80C3-3863BB430E3F,11236,40.638176,-73.889479,2.5,"SINGLE FAM RES, DETA",A1,RR101,1,,11046,16795,27841,196000,298000,494000,2017
D004C257-730B-E811-80C3-3863BB430E3F,11236,40.638581,-73.889459,2.5,"SINGLE FAM RES, DETA",A1,RR101,1,,11132,18463,29595,202000,335000,537000,2017
B48EB857-730B-E811-80C3-3863BB430E3F,11236,40.639554,-73.889354,2.5,"SFR,PERMANENT LIVING",A2,RR101,1,,7444,11364,18808,169000,258000,427000,2017
728AA557-730B-E811-80C3-3863BB430E3F,11236,40.637372,-73.889291,2.6,"SFR,PERMANENT LIVING",A2,RR101,1,,4055,7682,11737,85000,161000,246000,2017
6820C257-730B-E811-80C3-3863BB430E3F,11236,40.638406,-73.889263,2.4,"SINGLE FAM RES, DETA",A1,RR101,1,,10104,16997,27101,192000,323000,515000,2017
9CC9D957-730B-E811-80C3-3863BB430E3F,11236,40.639069,-73.889242,2.4,"SINGLE FAM RES, DETA",A1,RR101,1,,8328,14256,22584,177000,303000,480000,2017
CA7DAC57-730B-E811-80C3-3863BB430E3F,11236,40.637416,-73.889178,2.6,"SFR,PERMANENT LIVING",A2,RR101,1,,1661,6129,7790,58000,214000,272000,2017
AEE3A257-730B-E811-80C3-3863BB430E3F,11236,40.638318,-73.889164,2.4,"SINGLE FAM RES, DETA",A1,RR101,1,,10542,18041,28583,194000,332000,526000,2017
04C4BF57-730B-E811-80C3-3863BB430E3F,11236,40.639425,-73.889158,2.4,"SINGLE FAM RES, DETA",A1,RR101,1,,8248,14200,22448,176000,303000,479000,2017
F2DACB57-730B-E811-80C3-3863BB430E3F,11236,40.638982,-73.889144,2.4,"SINGLE FAM RES, DETA",A1,RR101,1,,8278,14170,22448,177000,303000,480000,2017
A6E3C157-730B-E811-80C3-3863BB430E3F,11236,40.638894,-73.889047,2.4,"SINGLE FAM RES, DETA",A1,RR101,1,,8257,14461,22718,177000,310000,487000,2017
5D029C57-730B-E811-80C3-3863BB430E3F,11236,40.638143,-73.888969,2.4,"SINGLE FAM RES, DETA",A1,RR101,1,,10542,18041,28583,194000,332000,526000,2017
9CD7AE57-730B-E811-80C3-3863BB430E3F,11236,40.638807,-73.888949,2.3,"SINGLE FAM RES, DETA",A1,RR101,1,,8402,14383,22785,177000,303000,480000,2017
A4F5A257-730B-E811-80C3-3863BB430E3F,11236,40.638054,-73.88887,2.4,"SINGLE FAM RES, DETA",A1,RR101,1,,11637,16879,28516,202000,293000,495000,2017
43F5B557-730B-E811-80C3-3863BB430E3F,11236,40.637966,-73.888772,2.4,"SINGLE FAM RES, DETA",A1,RR101,1,,13006,17516,30522,225000,303000,528000,2017
7C7ACB57-730B-E811-80C3-3863BB430E3F,11236,40.637878,-73.888673,2.4,"SINGLE FAM RES, DETA",A1,RR101,1,,11664,16919,28583,202000,293000,495000,2017
0F0AAF57-730B-E811-80C3-3863BB430E3F,11236,40.639734,-73.888671,2.4,"SINGLE FAM RES, DETA",A1,RR101,1,,10395,18391,28786,195000,345000,540000,2017
A02FDC57-730B-E811-80C3-3863BB430E3F,11236,40.640044,-73.88859,2.3,"SFR,PERMANENT LIVING",A2,RR101,1,,8248,13325,21573,169000,273000,442000,2017
E67CC457-730B-E811-80C3-3863BB430E3F,11236,40.639647,-73.888575,2.3,"SINGLE FAM RES, DETA",A1,RR101,1,,9135,18168,27303,179000,356000,535000,2017
66EFBF57-730B-E811-80C3-3863BB430E3F,11236,40.638457,-73.888559,2.3,"SINGLE FAM RES, DETA",A1,RR101,1,,8675,14852,23527,177000,303000,480000,2017
54C0BF57-730B-E811-80C3-3863BB430E3F,11236,40.64075,-73.888505,2.3,"SFR,PERMANENT LIVING",A2,RR101,1,,7746,13017,20763,169000,284000,453000,2017
7564A557-730B-E811-80C3-3863BB430E3F,11236,40.640117,-73.88848,2.3,"SINGLE FAM RES, DETA",A1,RR101,1,,11059,17524,28583,207000,328000,535000,2017
F7F99B57-730B-E811-80C3-3863BB430E3F,11236,40.638369,-73.888462,2.3,"SINGLE FAM RES, DETA",A1,RR101,1,,8995,13328,22323,191000,283000,474000,2017
EF03C255-730B-E811-80C3-3863BB430E3F,11236,40.639915,-73.888398,2.3,"SINGLE FAM RES, DETA",A1,RR101,1,,10477,17723,28200,201000,340000,541000,2017
5A10D557-730B-E811-80C3-3863BB430E3F,11236,40.639828,-73.888301,2.3,"SINGLE FAM RES, DETA",A1,RR101,1,,11439,17819,29258,199000,310000,509000,2017
B4F7D457-730B-E811-80C3-3863BB430E3F,11236,40.640371,-73.888086,2.2,"SFR,PERMANENT LIVING",A2,RR101,1,,7534,11679,19213,169000,262000,431000,2017
8CFBA257-730B-E811-80C3-3863BB430E3F,11236,40.640442,-73.887976,2.2,"SFR,PERMANENT LIVING",A2,RR101,1,,7507,11638,19145,169000,262000,431000,2017
C801C257-730B-E811-80C3-3863BB430E3F,11236,40.640204,-73.887946,2.2,"SINGLE FAM RES, DETA",A1,RR101,1,,11580,18083,29663,203000,317000,520000,2017
5655D057-730B-E811-80C3-3863BB430E3F,11236,40.640585,-73.887754,2.1,"SINGLE FAM RES, DETA",A1,RR101,1,,12155,17440,29595,207000,297000,504000,2017
59739957-730B-E811-80C3-3863BB430E3F,11236,40.640259,-73.886305,1.9,"SINGLE FAM RES, DETA",A1,RR101,1,,13724,20275,33999,264000,390000,654000,2017
8C39DC57-730B-E811-80C3-3863BB430E3F,11236,40.64035,-73.886165,1.9,"SINGLE FAM RES, DETA",A1,RR101,1,,8706,18597,27303,169000,361000,530000,2017
0DED9B57-730B-E811-80C3-3863BB430E3F,11236,40.640421,-73.886055,1.9,"SINGLE FAM RES, DETA",A1,RR101,1,,8706,18597,27303,169000,361000,530000,2017
92AFCB57-730B-E811-80C3-3863BB430E3F,11236,40.640492,-73.885945,1.9,"SINGLE FAM RES, DETA",A1,RR101,1,,11050,21713,32763,199000,391000,590000,2017
1EDBCD57-730B-E811-80C3-3863BB430E3F,11236,40.640563,-73.885836,1.8,"SINGLE FAM RES, DETA",A1,RR101,1,,8723,14618,23341,185000,310000,495000,2017
5892BF57-730B-E811-80C3-3863BB430E3F,11236,40.640634,-73.885726,1.8,"SINGLE FAM RES, DETA",A1,RR101,1,,8706,18597,27303,169000,361000,530000,2017
1E2BAA57-730B-E811-80C3-3863BB430E3F,11236,40.640103,-73.885707,1.9,"SINGLE FAM RES, DETA",A1,RR101,1,,8164,19274,27438,169000,399000,568000,2017
78B6A057-730B-E811-80C3-3863BB430E3F,11236,40.640705,-73.885616,1.8,"SINGLE FAM RES, DETA",A1,RR101,1,,8216,19154,27370,169000,394000,563000,2017
F2BFCB57-730B-E811-80C3-3863BB430E3F,11236,40.640175,-73.885596,1.8,"SINGLE FAM RES, DETA",A1,RR101,1,,8124,19179,27303,169000,399000,568000,2017
8B41B157-730B-E811-80C3-3863BB430E3F,11236,40.640777,-73.885506,1.8,"SINGLE FAM RES, DETA",A1,RR101,1,,8723,14618,23341,185000,310000,495000,2017
1CA2BF57-730B-E811-80C3-3863BB430E3F,11236,40.640316,-73.885377,1.8,"SINGLE FAM RES, DETA",A1,RR101,1,,8608,18695,27303,169000,367000,536000,2017
4A21DC57-730B-E811-80C3-3863BB430E3F,11236,40.640919,-73.885287,1.7,"SINGLE FAM RES, DETA",A1,RR101,1,,8764,17057,25821,186000,362000,548000,2017
23DBBA57-730B-E811-80C3-3863BB430E3F,11236,40.641061,-73.885068,1.7,"SINGLE FAM RES, DETA",A1,RR101,1,,8949,16690,25639,185000,345000,530000,2017
9296B857-730B-E811-80C3-3863BB430E3F,11236,40.640604,-73.884932,1.8,"SINGLE FAM RES, DETA",A1,RR101,1,,8023,18943,26966,169000,399000,568000,2017
E1EF9B57-730B-E811-80C3-3863BB430E3F,11236,40.640675,-73.884823,1.7,"SINGLE FAM RES, DETA",A1,RR101,1,,8396,18233,26629,169000,367000,536000,2017
D837AA57-730B-E811-80C3-3863BB430E3F,11236,40.640902,-73.884472,1.7,"SINGLE FAM RES, DETA",A1,RR101,1,,14302,17046,31348,292000,348000,640000,2017
FE97CB57-730B-E811-80C3-3863BB430E3F,11236,40.639072,-73.884366,2.2,"SINGLE FAM RES, DETA",A1,RR101,1,,7494,15831,23325,169000,357000,526000,2017
2EBFCB57-730B-E811-80C3-3863BB430E3F,11236,40.638789,-73.884239,2.4,"SINGLE FAM RES, DETA",A1,RR101,1,,7424,15024,22448,169000,342000,511000,2017
69DCBA57-730B-E811-80C3-3863BB430E3F,11236,40.63886,-73.884129,2.3,"SINGLE FAM RES, DETA",A1,RR101,1,,7424,15024,22448,169000,342000,511000,2017
B6A9D257-730B-E811-80C3-3863BB430E3F,11236,40.638931,-73.884019,2.3,"SINGLE FAM RES, DETA",A1,RR101,1,,9111,21226,30337,185000,431000,616000,2017
38A9D257-730B-E811-80C3-3863BB430E3F,11236,40.639427,-73.883817,2.1,"SINGLE FAM RES, DETA",A1,RR101,1,,7424,15024,22448,169000,342000,511000,2017
9C73CB57-730B-E811-80C3-3863BB430E3F,11236,40.639216,-73.883579,2.2,"SFR,PERMANENT LIVING",A2,RR101,1,,7424,15024,22448,169000,342000,511000,2017
2635D057-730B-E811-80C3-3863BB430E3F,11236,40.63964,-73.883488,2,"SINGLE FAM RES, DETA",A1,RR101,1,,7424,15024,22448,169000,342000,511000,2017
06679957-730B-E811-80C3-3863BB430E3F,11236,40.639712,-73.883378,2,"SINGLE FAM RES, DETA",A1,RR101,1,,7424,15024,22448,169000,342000,511000,2017
423DD057-730B-E811-80C3-3863BB430E3F,11236,40.639358,-73.88336,2.1,"SINGLE FAM RES, DETA",A1,RR101,1,,7494,15831,23325,169000,357000,526000,2017
A4D2BF57-730B-E811-80C3-3863BB430E3F,11236,40.639796,-73.883247,1.9,"SINGLE FAM RES, DETA",A1,RR101,1,,16322,14149,30471,308000,267000,575000,2017